query	subject	evalue	alnlength	identity	identical	mismatches	qframe	sframe	bframe
ENSG00000004059	ENSG00000143761	5.5e-97	178	81.461	145	33	2	1	2/1
ENSG00000006116	ENSG00000166862	5.47e-132	175	84.571	148	27	3	2	3/2
ENSG00000004975	ENSG00000161202	0	131	91.603	120	11	2	3	2/3
ENSG00000004975	ENSG00000107404	0	131	81.679	107	24	2	1	2/1
ENSG00000006451	ENSG00000144118	1.07e-71	126	89.683	113	13	3	1	3/1
ENSG00000006451	ENSG00000144118	1.07e-71	126	89.683	113	13	3	2	3/2
ENSG00000010017	ENSG00000141084	2.65e-154	110	83.636	92	18	-2	-1	-2/-1
ENSG00000011478	ENSG00000138600	2.61e-83	106	81.132	86	20	2	3	2/3
ENSG00000006059	ENSG00000131738	0	386	93.264	360	26	1	3	1/3
ENSG00000006059	ENSG00000094796	0	373	93.834	350	23	1	3	1/3
ENSG00000015568	ENSG00000183054	0	946	100	946	0	-3	-2	-3/-2
ENSG00000015568	ENSG00000169629	0	946	99.683	943	3	-3	-2	-3/-2
ENSG00000050327	ENSG00000213214	0	389	99.486	387	2	2	3	2/3
ENSG00000037965	ENSG00000175879	6.45e-76	101	83.168	84	17	3	2	3/2
ENSG00000059804	ENSG00000173262	0	523	92.352	483	40	1	2	1/2
ENSG00000059804	ENSG00000173262	0	523	92.352	483	40	1	2	1/2
ENSG00000019549	ENSG00000124216	4.92e-73	113	85.841	97	16	3	2	3/2
ENSG00000088256	ENSG00000156052	0	360	90.278	325	35	3	2	3/2
ENSG00000088256	ENSG00000156049	0	356	81.742	291	65	3	2	3/2
ENSG00000170848	ENSG00000183668	0	446	90.135	402	44	1	2	1/2
ENSG00000069943	ENSG00000260916	3.26e-73	125	98.4	123	2	-1	2	-1/2
ENSG00000069943	ENSG00000260916	3.26e-73	125	98.4	123	2	-1	1	-1/1
ENSG00000186847	ENSG00000128422	0	312	89.423	279	33	1	3	1/3
ENSG00000186847	ENSG00000186832	0	312	88.141	275	37	1	3	1/3
ENSG00000071655	ENSG00000267059	1.73e-115	182	100	182	0	-1	-3	-1/-3
ENSG00000127663	ENSG00000107077	0	357	80.952	289	68	3	1	3/1
ENSG00000112852	ENSG00000120327	0	124	95.161	118	6	-2	-1	-2/-1
ENSG00000112852	ENSG00000272674	0	124	89.516	111	13	-2	-1	-2/-1
ENSG00000077080	ENSG00000136518	0	363	87.328	317	46	3	1	3/1
ENSG00000077080	ENSG00000136518	0	363	87.328	317	46	3	1	3/1
ENSG00000073598	ENSG00000073536	5.54e-140	151	99.338	150	1	2	-3	2/-3
ENSG00000068976	ENSG00000100994	0	833	84.154	701	132	1	3	1/3
ENSG00000068971	ENSG00000154001	0	283	81.625	231	52	2	3	2/3
ENSG00000068971	ENSG00000154001	0	283	81.625	231	52	2	1	2/1
ENSG00000087303	ENSG00000087302	0	236	98.729	233	3	3	-1	3/-1
ENSG00000100030	ENSG00000102882	0	346	88.15	305	41	1	2	1/2
ENSG00000083812	ENSG00000249471	0	516	90.891	469	47	2	3	2/3
ENSG00000100345	ENSG00000133026	0	700	83.286	583	117	1	2	1/2
ENSG00000099800	ENSG00000178297	1.83e-55	105	100	105	0	-2	2	-2/2
ENSG00000243811	ENSG00000128394	0	246	88.211	217	29	3	1	3/1
ENSG00000243811	ENSG00000244509	3.73e-152	119	82.353	98	21	2	1	2/1
ENSG00000100836	ENSG00000258643	7.71e-108	195	100	195	0	2	1	2/1
ENSG00000100836	ENSG00000258643	7.71e-108	195	100	195	0	2	1	2/1
ENSG00000090581	ENSG00000059145	0	302	100	302	0	2	-2	2/-2
ENSG00000090581	ENSG00000059145	6.02e-178	302	100	302	0	3	-3	3/-3
ENSG00000100314	ENSG00000100319	5.88e-83	139	97.122	135	4	-1	1	-1/1
ENSG00000101210	ENSG00000156508	0	226	82.301	186	40	-2	-3	-2/-3
ENSG00000101405	ENSG00000101200	2.33e-54	107	80.374	86	21	-2	-1	-2/-1
ENSG00000100412	ENSG00000100413	0	171	100	171	0	-2	2	-2/2
ENSG00000100412	ENSG00000100413	0	171	100	171	0	-2	3	-2/3
ENSG00000187758	ENSG00000248144	0	494	90.486	447	47	1	2	1/2
ENSG00000187758	ENSG00000196616	0	446	90.583	404	42	1	3	1/3
ENSG00000086232	ENSG00000106305	7.52e-106	178	100	178	0	2	-1	2/-1
ENSG00000089723	ENSG00000089737	1.24e-149	213	100	213	0	-2	3	-2/3
ENSG00000089723	ENSG00000089737	4.07e-132	213	100	213	0	1	-1	1/-1
ENSG00000095917	ENSG00000172236	0	282	85.106	240	42	2	1	2/1
ENSG00000099974	ENSG00000099977	4.27e-61	104	96.154	100	4	-3	-2	-3/-2
ENSG00000099974	ENSG00000099977	4.27e-61	104	96.154	100	4	-3	-2	-3/-2
ENSG00000100485	ENSG00000115904	0	181	80.11	145	36	3	1	3/1
ENSG00000100028	ENSG00000138867	9.27e-69	107	100	107	0	2	-3	2/-3
ENSG00000100028	ENSG00000138867	7.91e-63	107	100	107	0	1	-2	1/-2
ENSG00000101292	ENSG00000169618	1.1e-152	241	84.232	203	38	-2	-3	-2/-3
ENSG00000100504	ENSG00000100994	0	697	80.775	563	134	1	3	1/3
ENSG00000087510	ENSG00000008196	1.27e-116	126	85.714	108	18	1	2	1/2
ENSG00000087510	ENSG00000137203	1.09e-107	144	80.556	116	28	1	3	1/3
ENSG00000101162	ENSG00000124172	0	395	100	395	0	-3	2	-3/2
ENSG00000101162	ENSG00000137285	0	433	80.6	349	84	3	1	3/1
ENSG00000099804	ENSG00000107341	8.22e-122	198	86.869	172	26	2	3	2/3
ENSG00000086548	ENSG00000105388	3.76e-175	159	83.648	133	26	-3	-2	-3/-2
ENSG00000086548	ENSG00000105388	4.44e-175	159	83.648	133	26	-3	-2	-3/-2
ENSG00000100450	ENSG00000100453	4.38e-108	129	86.047	111	18	1	3	1/3
ENSG00000092607	ENSG00000112837	7.75e-157	234	85.47	200	34	1	3	1/3
ENSG00000100490	ENSG00000125375	2.67e-175	258	99.225	256	2	1	-2	1/-2
ENSG00000100994	ENSG00000068976	0	697	83.07	579	118	3	1	3/1
ENSG00000100453	ENSG00000100450	7.72e-110	152	84.211	128	24	3	1	3/1
ENSG00000083720	ENSG00000198754	0	221	80.543	178	43	3	1	3/1
ENSG00000100564	ENSG00000054690	3.88e-65	100	100	100	0	2	-3	2/-3
ENSG00000100564	ENSG00000054690	1.5e-61	100	100	100	0	3	-1	3/-1
ENSG00000100564	ENSG00000054690	2.06e-61	100	100	100	0	-1	3	-1/3
ENSG00000100564	ENSG00000054690	1.01e-60	100	100	100	0	-2	1	-2/1
ENSG00000100564	ENSG00000054690	3.59e-60	100	100	100	0	1	-2	1/-2
ENSG00000100564	ENSG00000054690	9.3e-56	100	100	100	0	-3	2	-3/2
ENSG00000090060	ENSG00000218823	0	527	82.922	437	90	-2	-3	-2/-3
ENSG00000088356	ENSG00000131044	2.98e-133	207	100	207	0	-1	1	-1/1
ENSG00000100104	ENSG00000100109	0	338	91.124	308	30	-1	2	-1/2
ENSG00000100104	ENSG00000100109	0	338	91.124	308	30	-1	3	-1/3
ENSG00000197208	ENSG00000197375	0	322	86.025	277	45	1	3	1/3
ENSG00000108773	ENSG00000114166	0	239	83.682	200	39	1	3	1/3
ENSG00000103021	ENSG00000103023	1.22e-173	254	100	254	0	3	-2	3/-2
ENSG00000039123	ENSG00000067113	1.23e-100	160	100	160	0	1	-2	1/-2
ENSG00000039123	ENSG00000067113	6.0100000000000005e-100	160	100	160	0	-2	2	-2/2
ENSG00000039123	ENSG00000067113	5.55e-99	160	100	160	0	-3	3	-3/3
ENSG00000111664	ENSG00000078369	0	341	83.284	284	57	1	3	1/3
ENSG00000111664	ENSG00000078369	0	341	83.284	284	57	1	3	1/3
ENSG00000105258	ENSG00000105254	1.7e-77	120	100	120	0	-1	1	-1/1
ENSG00000105258	ENSG00000105254	7.7e-76	120	100	120	0	2	-1	2/-1
ENSG00000105254	ENSG00000105258	3.44e-79	120	100	120	0	2	-2	2/-2
ENSG00000105254	ENSG00000105258	2.94e-77	120	100	120	0	1	-1	1/-1
ENSG00000105254	ENSG00000105258	1.33e-75	120	100	120	0	-1	2	-1/2
ENSG00000114784	ENSG00000173812	1.19e-59	116	92.241	107	9	1	3	1/3
ENSG00000104848	ENSG00000111262	1.66e-145	149	85.235	127	22	3	1	3/1
ENSG00000109061	ENSG00000264424	0	630	95.873	604	26	3	1	3/1
ENSG00000105649	ENSG00000152932	1.68e-123	194	88.66	172	22	3	2	3/2
ENSG00000105649	ENSG00000169213	9.63e-114	196	82.653	162	34	3	1	3/1
ENSG00000104695	ENSG00000113575	0	310	97.419	302	8	2	3	2/3
ENSG00000108417	ENSG00000171360	0	252	87.302	220	32	-1	-2	-1/-2
ENSG00000113211	ENSG00000113209	0	299	83.612	250	49	-2	-1	-2/-1
ENSG00000114853	ENSG00000198740	0	260	91.538	238	22	3	2	3/2
ENSG00000114853	ENSG00000198740	0	260	91.538	238	22	3	2	3/2
ENSG00000197417	ENSG00000262304	0	844	100	844	0	2	1	2/1
ENSG00000111245	ENSG00000106436	5.44e-80	137	81.752	112	25	1	2	1/2
ENSG00000111786	ENSG00000257218	3.17e-64	102	100	102	0	2	-1	2/-1
ENSG00000104964	ENSG00000106829	7.26e-57	108	84.259	91	17	1	3	1/3
ENSG00000125149	ENSG00000237172	2.51e-102	145	100	145	0	1	-1	1/-1
ENSG00000125149	ENSG00000237172	7.62e-100	145	100	145	0	-1	2	-1/2
ENSG00000108590	ENSG00000129235	0	408	100	408	0	3	-2	3/-2
ENSG00000107018	ENSG00000107014	5.52e-139	260	83.462	217	43	-3	-2	-3/-2
ENSG00000106588	ENSG00000256646	6.04e-162	261	99.617	260	1	-2	-1	-2/-1
ENSG00000108684	ENSG00000110881	0	160	85	136	24	1	2	1/2
ENSG00000105516	ENSG00000063176	1.52e-87	125	100	125	0	2	-1	2/-1
ENSG00000105516	ENSG00000063176	2.44e-81	125	100	125	0	-1	1	-1/1
ENSG00000105516	ENSG00000063176	2.64e-70	125	100	125	0	-2	2	-2/2
ENSG00000105516	ENSG00000063176	2.09e-55	125	100	125	0	3	-2	3/-2
ENSG00000105516	ENSG00000063176	2.44e-81	125	100	125	0	-1	1	-1/1
ENSG00000105516	ENSG00000063176	2.64e-70	125	100	125	0	-2	2	-2/2
ENSG00000105516	ENSG00000063176	2.09e-55	125	100	125	0	3	-1	3/-1
ENSG00000111615	ENSG00000139278	0	379	99.736	378	1	-2	2	-2/2
ENSG00000113205	ENSG00000272674	0	130	87.692	114	16	-2	-1	-2/-1
ENSG00000112855	ENSG00000170445	3.47e-64	117	96.581	113	4	2	-1	2/-1
ENSG00000078967	ENSG00000131508	5.68e-96	149	92.617	138	11	3	1	3/1
ENSG00000186115	ENSG00000186529	0	694	93.372	648	46	1	2	1/2
ENSG00000186115	ENSG00000186529	0	694	93.372	648	46	1	3	1/3
ENSG00000106258	ENSG00000160868	0	442	83.032	367	75	-2	-3	-2/-3
ENSG00000106258	ENSG00000282301	0	422	81.754	345	77	2	1	2/1
ENSG00000105953	ENSG00000197444	0	706	83.711	591	115	1	3	1/3
ENSG00000105664	ENSG00000113296	0	271	87.823	238	33	1	2	1/2
ENSG00000105664	ENSG00000113296	0	271	87.823	238	33	1	2	1/2
ENSG00000103064	ENSG00000103061	0	977	100	977	0	-3	2	-3/2
ENSG00000016082	ENSG00000159556	0	188	81.383	153	35	3	2	3/2
ENSG00000114349	ENSG00000134183	0	326	83.129	271	55	1	2	1/2
ENSG00000104835	ENSG00000128626	4.58e-74	116	100	116	0	2	-2	2/-2
ENSG00000104835	ENSG00000128626	6.29e-74	116	100	116	0	-2	1	-2/1
ENSG00000113212	ENSG00000120324	0	106	90.566	96	10	-3	-1	-3/-1
ENSG00000112309	ENSG00000112305	0	519	100	519	0	3	-1	3/-1
ENSG00000112309	ENSG00000112305	0	519	100	519	0	3	-2	3/-2
ENSG00000104863	ENSG00000148943	2.56e-101	204	82.353	168	36	3	1	3/1
ENSG00000103121	ENSG00000136213	7.16e-132	101	84.158	85	16	-3	-2	-3/-2
ENSG00000108759	ENSG00000197079	1.25e-179	329	80.851	266	63	3	2	3/2
ENSG00000123908	ENSG00000092847	0	838	83.652	701	137	3	1	3/1
ENSG00000113851	ENSG00000072756	1.18e-72	116	98.276	114	2	2	-3	2/-3
ENSG00000107796	ENSG00000159251	0	388	96.907	376	12	1	3	1/3
ENSG00000107796	ENSG00000163017	0	376	98.936	372	4	1	2	1/2
ENSG00000106305	ENSG00000086232	1.88e-106	178	100	178	0	-1	2	-1/2
ENSG00000109084	ENSG00000109083	1.5e-73	120	100	120	0	3	-1	3/-1
ENSG00000109084	ENSG00000109083	5.35e-69	120	100	120	0	-1	3	-1/3
ENSG00000109084	ENSG00000109083	7.35e-65	120	100	120	0	-2	1	-2/1
ENSG00000105647	ENSG00000268173	0	402	100	402	0	1	3	1/3
ENSG00000114904	ENSG00000114902	0	898	100	898	0	-3	2	-3/2
ENSG00000104129	ENSG00000137880	9.5e-128	161	100	161	0	-2	2	-2/2
ENSG00000104129	ENSG00000137880	1.24e-121	161	100	161	0	3	-1	3/-1
ENSG00000104129	ENSG00000137880	2.08e-116	161	100	161	0	-1	1	-1/1
ENSG00000104826	ENSG00000213030	1.95e-72	123	86.179	106	17	-1	-2	-1/-2
ENSG00000104826	ENSG00000104827	1.76e-71	123	86.179	106	17	-1	-2	-1/-2
ENSG00000102128	ENSG00000172476	0	254	98.031	249	5	3	2	3/2
ENSG00000102128	ENSG00000172476	0	254	98.031	249	5	3	1	3/1
ENSG00000108379	ENSG00000154342	0	347	85.014	295	52	2	1	2/1
ENSG00000106089	ENSG00000099365	7.14e-137	257	85.214	219	38	1	2	1/2
ENSG00000109272	ENSG00000163737	2.29e-47	102	87.255	89	13	-2	-3	-2/-3
ENSG00000104888	ENSG00000091664	0	512	82.422	422	90	2	3	2/3
ENSG00000104888	ENSG00000179520	0	178	84.831	151	27	2	1	2/1
ENSG00000175106	ENSG00000259024	3.3e-118	186	100	186	0	1	3	1/3
ENSG00000113248	ENSG00000113205	0	158	89.241	141	17	1	2	1/2
ENSG00000113248	ENSG00000272674	1.76e-172	160	85	136	24	1	2	1/2
ENSG00000108179	ENSG00000196262	1.16e-82	145	80	116	29	3	1	3/1
ENSG00000109107	ENSG00000149925	0	366	81.967	300	66	3	1	3/1
ENSG00000104221	ENSG00000020181	3.1e-158	236	100	236	0	-1	2	-1/2
ENSG00000104221	ENSG00000020181	1.4e-156	236	100	236	0	-2	3	-2/3
ENSG00000104221	ENSG00000020181	1.64e-150	236	100	236	0	3	-2	3/-2
ENSG00000102057	ENSG00000171385	0	241	84.232	203	38	3	2	3/2
ENSG00000102057	ENSG00000171385	0	241	84.232	203	38	3	1	3/1
ENSG00000113209	ENSG00000113211	0	104	91.346	95	9	-3	-1	-3/-1
ENSG00000091010	ENSG00000152192	2.8e-119	165	89.091	147	18	3	1	3/1
ENSG00000131738	ENSG00000006059	0	386	93.264	360	26	3	1	3/1
ENSG00000131738	ENSG00000094796	0	183	93.443	171	12	-2	-3	-2/-3
ENSG00000226941	ENSG00000169800	0	415	100	415	0	1	2	1/2
ENSG00000226941	ENSG00000234414	0	415	99.277	412	3	1	3	1/3
ENSG00000122543	ENSG00000135175	2.3e-153	231	98.268	227	4	-3	-1	-3/-1
ENSG00000129824	ENSG00000280969	4.44e-172	264	93.939	248	16	2	1	2/1
ENSG00000129824	ENSG00000198034	1.15e-171	265	92.83	246	19	2	1	2/1
ENSG00000028839	ENSG00000146411	0	463	100	463	0	1	-2	1/-2
ENSG00000127528	ENSG00000136826	3.24e-71	103	94.175	97	6	3	1	3/1
ENSG00000123584	ENSG00000267978	0	460	99.565	458	2	2	1	2/1
ENSG00000133275	ENSG00000151292	0	247	93.927	232	15	2	1	2/1
ENSG00000121297	ENSG00000179981	0	148	85.135	126	22	2	1	2/1
ENSG00000121297	ENSG00000179981	0	148	85.135	126	22	2	3	2/3
ENSG00000118160	ENSG00000100678	0	205	84.878	174	31	1	3	1/3
ENSG00000118160	ENSG00000100678	0	205	84.878	174	31	1	3	1/3
ENSG00000170454	ENSG00000186081	0	355	87.042	309	46	3	2	3/2
ENSG00000170454	ENSG00000205420	0	355	84.507	300	55	3	1	3/1
ENSG00000171360	ENSG00000108417	2.17e-169	159	90.566	144	15	-2	-1	-2/-1
ENSG00000129235	ENSG00000108590	0	408	100	408	0	2	-3	2/-3
ENSG00000129235	ENSG00000108590	0	408	100	408	0	-2	3	-2/3
ENSG00000130383	ENSG00000171124	0	316	91.772	290	26	2	3	2/3
ENSG00000121068	ENSG00000135111	4.79e-169	239	87.448	209	30	3	2	3/2
ENSG00000118804	ENSG00000272414	0	643	100	643	0	-3	-1	-3/-1
ENSG00000115825	ENSG00000184304	0	329	90.578	298	31	1	2	1/2
ENSG00000105447	ENSG00000182324	3.95e-63	116	100	116	0	2	1	2/1
ENSG00000124140	ENSG00000113504	0	256	89.453	229	27	2	3	2/3
ENSG00000111364	ENSG00000111361	2.37e-102	104	100	104	0	-2	2	-2/2
ENSG00000111364	ENSG00000111361	6.44e-99	104	100	104	0	-3	3	-3/3
ENSG00000111364	ENSG00000111361	1.11e-97	104	100	104	0	2	-2	2/-2
ENSG00000130810	ENSG00000243207	0	337	100	337	0	-1	-3	-1/-3
ENSG00000182521	ENSG00000112592	1.85e-115	195	90.256	176	19	3	1	3/1
ENSG00000126778	ENSG00000170577	1.6e-128	188	95.213	179	9	1	3	1/3
ENSG00000120149	ENSG00000141194	0	193	89.119	172	21	3	2	3/2
ENSG00000120149	ENSG00000163132	1.46e-68	109	80.734	88	21	2	1	2/1
ENSG00000254245	ENSG00000081853	0	412	100	412	0	3	2	3/2
ENSG00000119820	ENSG00000215193	0	100	85	85	15	3	-2	3/-2
ENSG00000132842	ENSG00000103723	0	240	82.083	197	43	3	2	3/2
ENSG00000125629	ENSG00000186480	3.09e-110	185	84.324	156	29	3	2	3/2
ENSG00000120324	ENSG00000177839	0	672	92.411	621	51	3	1	3/1
ENSG00000120324	ENSG00000113212	0	101	90.099	91	10	-1	-3	-1/-3
ENSG00000111801	ENSG00000026950	0	422	81.043	342	80	3	2	3/2
ENSG00000092345	ENSG00000205944	0	189	83.069	157	32	2	1	2/1
ENSG00000128276	ENSG00000128253	0	375	94.133	353	22	-1	-3	-1/-3
ENSG00000131462	ENSG00000037042	0	454	97.577	443	11	3	2	3/2
ENSG00000126368	ENSG00000126351	9.37e-43	102	89.216	91	11	2	-1	2/-1
ENSG00000124469	ENSG00000079385	1.39e-103	174	81.034	141	33	-1	-2	-1/-2
ENSG00000124469	ENSG00000079385	4.45e-102	174	81.034	141	33	-1	-3	-1/-3
ENSG00000134287	ENSG00000143761	1.6e-114	177	97.175	172	5	3	1	3/1
ENSG00000204604	ENSG00000198538	0	172	89.535	154	18	2	3	2/3
ENSG00000120952	ENSG00000116721	0	547	94.333	516	31	1	2	1/2
ENSG00000120952	ENSG00000204481	0	547	92.505	506	41	1	2	1/2
ENSG00000131094	ENSG00000165985	4.67e-87	133	87.218	116	17	3	2	3/2
ENSG00000131094	ENSG00000186897	7.33e-87	134	88.06	118	16	3	1	3/1
ENSG00000048392	ENSG00000171848	4.3e-175	154	86.364	133	21	2	1	2/1
ENSG00000138286	ENSG00000213551	7.6e-176	232	100	232	0	1	-3	1/-3
ENSG00000138286	ENSG00000213551	6.37e-159	232	100	232	0	3	-2	3/-2
ENSG00000138286	ENSG00000213551	2.62e-156	232	100	232	0	-3	1	-3/1
ENSG00000130489	ENSG00000284194	3.54e-180	192	100	192	0	3	1	3/1
ENSG00000130538	ENSG00000258453	0	327	98.777	323	4	1	3	1/3
ENSG00000130538	ENSG00000257115	0	327	98.777	323	4	1	3	1/3
ENSG00000130538	ENSG00000257115	0	327	98.777	323	4	2	1	2/1
ENSG00000130538	ENSG00000257115	0	327	98.777	323	4	-2	-1	-2/-1
ENSG00000134201	ENSG00000134184	8.82e-131	238	80.672	192	46	1	3	1/3
ENSG00000134201	ENSG00000168765	8.13e-112	143	83.217	119	24	-1	-3	-1/-3
ENSG00000129514	ENSG00000125798	6.21e-85	109	89.908	98	11	-3	-1	-3/-1
ENSG00000129514	ENSG00000125798	1.32e-83	109	89.908	98	11	-3	-1	-3/-1
ENSG00000132475	ENSG00000188375	0	129	96.899	125	4	2	1	2/1
ENSG00000114547	ENSG00000065371	0	293	95.904	281	12	2	1	2/1
ENSG00000173473	ENSG00000139613	0	129	86.047	111	18	1	2	1/2
ENSG00000120327	ENSG00000112852	0	110	83.636	92	18	-2	-3	-2/-3
ENSG00000132286	ENSG00000283977	1.12e-64	132	100	132	0	-3	-2	-3/-2
ENSG00000120322	ENSG00000272674	0	473	84.144	398	75	3	1	3/1
ENSG00000120322	ENSG00000187372	0	421	93.587	394	27	2	1	2/1
ENSG00000130733	ENSG00000142453	1.09e-136	245	100	245	0	2	-1	2/-1
ENSG00000214042	ENSG00000236637	8.82e-153	245	91.02	223	22	1	2	1/2
ENSG00000123353	ENSG00000135392	0	306	100	306	0	1	-1	1/-1
ENSG00000123353	ENSG00000135392	0	306	100	306	0	-3	3	-3/3
ENSG00000123353	ENSG00000135392	0	306	100	306	0	-1	1	-1/1
ENSG00000123353	ENSG00000135392	0	306	100	306	0	-2	2	-2/2
ENSG00000123353	ENSG00000135392	0	306	100	306	0	1	-1	1/-1
ENSG00000123353	ENSG00000135392	0	306	100	306	0	-3	1	-3/1
ENSG00000123353	ENSG00000135392	0	306	100	306	0	-1	2	-1/2
ENSG00000123353	ENSG00000135392	0	306	100	306	0	-2	3	-2/3
ENSG00000122691	ENSG00000233608	5.43e-59	104	92.308	96	8	1	2	1/2
ENSG00000122691	ENSG00000233608	5.43e-59	104	92.308	96	8	1	2	1/2
ENSG00000121075	ENSG00000089225	9.99e-147	197	90.863	179	18	1	2	1/2
ENSG00000132915	ENSG00000133256	0	326	82.209	268	58	1	2	1/2
ENSG00000160145	ENSG00000038382	0	182	86.264	157	25	2	1	2/1
ENSG00000134072	ENSG00000183049	0	323	82.353	266	57	2	3	2/3
ENSG00000115042	ENSG00000144199	0	329	96.657	318	11	-1	-3	-1/-3
ENSG00000134250	ENSG00000264343	2.6e-159	238	97.479	232	6	3	1	3/1
ENSG00000128383	ENSG00000179750	7.76e-173	229	93.886	215	14	3	1	3/1
ENSG00000123136	ENSG00000198563	0	403	91.811	370	33	1	2	1/2
ENSG00000121350	ENSG00000004700	0	481	99.376	478	3	3	-3	3/-3
ENSG00000128340	ENSG00000136238	6.04e-122	197	90.863	179	18	3	1	3/1
ENSG00000128340	ENSG00000169750	9.71e-120	203	85.714	174	29	3	1	3/1
ENSG00000130037	ENSG00000177301	2.82e-172	161	84.472	136	25	1	3	1/3
ENSG00000130037	ENSG00000177301	2.84e-172	161	84.472	136	25	1	2	1/2
ENSG00000128335	ENSG00000100342	0	170	84.706	144	26	1	2	1/2
ENSG00000127831	ENSG00000135913	0	705	100	705	0	2	-2	2/-2
ENSG00000115486	ENSG00000168906	3.62e-126	185	100	185	0	3	-3	3/-3
ENSG00000115486	ENSG00000168906	7.4e-119	185	100	185	0	-3	2	-3/2
ENSG00000130766	ENSG00000080546	4.54e-168	150	80	120	30	1	3	1/3
ENSG00000120738	ENSG00000179388	2.49e-71	113	85.841	97	16	3	2	3/2
ENSG00000120738	ENSG00000179388	2.53e-71	113	85.841	97	16	3	2	3/2
ENSG00000120903	ENSG00000101204	0	307	80.13	246	61	3	2	3/2
ENSG00000120709	ENSG00000158402	2.84e-58	104	89.423	93	11	3	-3	3/-3
ENSG00000215397	ENSG00000261678	4.79e-93	135	91.111	123	12	3	2	3/2
ENSG00000100056	ENSG00000206203	0	605	100	605	0	-3	2	-3/2
ENSG00000100056	ENSG00000212122	1.24e-163	277	82.31	228	49	-3	1	-3/1
ENSG00000133488	ENSG00000214491	0	229	82.969	190	39	-2	-1	-2/-1
ENSG00000171903	ENSG00000186529	0	488	86.68	423	65	2	3	2/3
ENSG00000115386	ENSG00000172023	2.78e-108	217	81.106	176	41	-2	-1	-2/-1
ENSG00000100722	ENSG00000165521	0	839	100	839	0	3	-2	3/-2
ENSG00000124216	ENSG00000019549	1.92e-75	113	85.841	97	16	2	3	2/3
ENSG00000134108	ENSG00000143862	2.85e-115	183	91.257	167	16	1	2	1/2
ENSG00000171346	ENSG00000171401	1.95e-171	316	85.443	270	46	2	3	2/3
ENSG00000125398	ENSG00000100146	4.27e-128	121	90.909	110	11	1	2	1/2
ENSG00000125398	ENSG00000100146	4.4e-128	121	90.909	110	11	1	2	1/2
ENSG00000120137	ENSG00000125779	0	202	81.683	165	37	3	1	3/1
ENSG00000122696	ENSG00000141437	0	306	95.425	292	14	-2	-1	-2/-1
ENSG00000130254	ENSG00000160633	0	161	81.366	131	30	-1	-2	-1/-2
ENSG00000269741	ENSG00000213022	4.41e-173	251	100	251	0	-3	-1	-3/-1
ENSG00000269741	ENSG00000213022	1.14e-152	251	100	251	0	-1	-2	-1/-2
ENSG00000269741	ENSG00000129455	6.79e-86	103	99.029	102	1	-3	-2	-3/-2
ENSG00000037042	ENSG00000131462	0	465	96.344	448	17	2	3	2/3
ENSG00000058262	ENSG00000065665	0	475	93.684	445	30	2	3	2/3
ENSG00000130402	ENSG00000072110	0	883	86.75	766	117	2	1	2/1
ENSG00000122728	ENSG00000147133	0	847	92.798	786	61	3	1	3/1
ENSG00000125347	ENSG00000003402	3.82e-117	118	83.898	99	19	1	-2	1/-2
ENSG00000119729	ENSG00000151665	2.05e-143	219	100	219	0	2	-1	2/-1
ENSG00000119729	ENSG00000126785	4.2e-100	190	80	152	38	2	1	2/1
ENSG00000125249	ENSG00000123728	1.75e-93	184	91.304	168	16	1	3	1/3
ENSG00000213463	ENSG00000258644	1.78e-82	137	94.891	130	7	2	1	2/1
ENSG00000213463	ENSG00000258644	2.45e-66	137	94.891	130	7	-2	-1	-2/-1
ENSG00000124172	ENSG00000101162	0	395	100	395	0	-2	3	-2/3
ENSG00000124172	ENSG00000101162	0	395	100	395	0	1	-2	1/-2
ENSG00000124172	ENSG00000101162	0	395	100	395	0	2	-3	2/-3
ENSG00000130449	ENSG00000162415	0	532	80.263	427	105	1	3	1/3
ENSG00000126822	ENSG00000070182	0	558	100	558	0	-2	1	-2/1
ENSG00000126822	ENSG00000070182	0	558	100	558	0	-2	2	-2/2
ENSG00000119778	ENSG00000156802	0	335	81.791	274	61	3	1	3/1
ENSG00000130544	ENSG00000167785	0	170	81.765	139	31	-2	-1	-2/-1
ENSG00000128245	ENSG00000170027	4.01e-142	246	86.992	214	32	1	2	1/2
ENSG00000127824	ENSG00000123416	0	438	97.489	427	11	1	3	1/3
ENSG00000133703	ENSG00000174775	1.24e-98	188	85.106	160	28	2	3	2/3
ENSG00000133243	ENSG00000064726	0	379	84.697	321	58	1	3	1/3
ENSG00000120329	ENSG00000102743	0	315	86.667	273	42	1	3	1/3
ENSG00000125414	ENSG00000109061	0	629	93.482	588	41	2	3	2/3
ENSG00000131480	ENSG00000131471	0	159	84.906	135	24	1	2	1/2
ENSG00000125459	ENSG00000116580	0	225	91.111	205	20	2	-1	2/-1
ENSG00000125459	ENSG00000116580	0	225	91.111	205	20	2	-3	2/-3
ENSG00000112659	ENSG00000044090	0	210	85.714	180	30	-3	-1	-3/-1
ENSG00000112659	ENSG00000044090	0	210	85.714	180	30	-3	-1	-3/-1
ENSG00000115392	ENSG00000028116	3.69e-94	159	96.226	153	6	2	-2	2/-2
ENSG00000106526	ENSG00000133627	7.79e-140	217	93.088	202	15	-3	-2	-3/-2
ENSG00000131459	ENSG00000198380	0	446	81.166	362	84	3	1	3/1
ENSG00000131459	ENSG00000198380	0	446	81.166	362	84	3	1	3/1
ENSG00000130283	ENSG00000223802	0	260	100	260	0	-2	-1	-2/-1
ENSG00000197375	ENSG00000197208	0	322	86.025	277	45	3	1	3/1
ENSG00000264424	ENSG00000109061	0	862	95.592	824	38	1	3	1/3
ENSG00000264424	ENSG00000125414	0	635	91.969	584	51	1	3	1/3
ENSG00000198342	ENSG00000196466	0	522	80.651	421	101	-1	-2	-1/-2
ENSG00000282608	ENSG00000121933	9.94e-121	163	100	163	0	1	2	1/2
ENSG00000132517	ENSG00000185803	0	108	83.333	90	18	2	3	2/3
ENSG00000124657	ENSG00000168131	5.33e-171	310	81.613	253	57	1	3	1/3
ENSG00000104974	ENSG00000104972	0	496	83.266	413	83	-2	-1	-2/-1
ENSG00000132207	ENSG00000181625	0	244	100	244	0	2	1	2/1
ENSG00000134590	ENSG00000203950	1.66e-171	179	86.592	155	24	-3	-2	-3/-2
ENSG00000134590	ENSG00000212747	1.28e-158	179	87.709	157	22	-3	-1	-3/-1
ENSG00000126890	ENSG00000268651	1.03e-104	150	85.333	128	22	3	1	3/1
ENSG00000170465	ENSG00000185479	0	190	100	190	0	-2	-1	-2/-1
ENSG00000109805	ENSG00000178177	0	474	100	474	0	-2	1	-2/1
ENSG00000118579	ENSG00000047662	0	1107	100	1107	0	3	-1	3/-1
ENSG00000119638	ENSG00000119703	1.41e-149	211	100	211	0	-2	2	-2/2
ENSG00000119638	ENSG00000119703	8.79e-144	211	100	211	0	2	-1	2/-1
ENSG00000119638	ENSG00000119703	2.28e-143	211	100	211	0	-1	1	-1/1
ENSG00000119638	ENSG00000119703	2.89e-142	211	100	211	0	1	-3	1/-3
ENSG00000119638	ENSG00000119703	6.4e-140	211	100	211	0	-3	3	-3/3
ENSG00000169951	ENSG00000261459	0	122	81.967	100	22	-1	-3	-1/-3
ENSG00000130950	ENSG00000188152	0	377	97.347	367	10	-3	-1	-3/-1
ENSG00000125966	ENSG00000156103	0	176	85.227	150	26	2	1	2/1
ENSG00000125966	ENSG00000157227	0	112	81.25	91	21	2	1	2/1
ENSG00000131873	ENSG00000198108	0	371	80.054	297	74	3	2	3/2
ENSG00000131368	ENSG00000177463	2.53e-168	252	100	252	0	-1	2	-1/2
ENSG00000131368	ENSG00000177463	8.34e-159	252	100	252	0	3	-1	3/-1
ENSG00000134538	ENSG00000111700	0	520	80	416	104	1	2	1/2
ENSG00000094796	ENSG00000006059	0	359	95.822	344	15	3	1	3/1
ENSG00000094796	ENSG00000131738	2.05e-177	192	93.229	179	13	-3	-2	-3/-2
ENSG00000134308	ENSG00000166913	7.32e-127	229	83.406	191	38	1	2	1/2
ENSG00000204577	ENSG00000244482	0	401	94.763	380	21	3	2	3/2
ENSG00000123143	ENSG00000065243	0	331	80.363	266	65	1	3	1/3
ENSG00000196757	ENSG00000171291	0	112	88.393	99	13	-2	-3	-2/-3
ENSG00000262246	ENSG00000103426	0	598	100	598	0	-3	-1	-3/-1
ENSG00000187545	ENSG00000204479	0	489	86.912	425	64	-3	-2	-3/-2
ENSG00000100890	ENSG00000258790	0	485	99.381	482	3	-2	-3	-2/-3
ENSG00000074800	ENSG00000111674	0	431	83.991	362	69	1	3	1/3
ENSG00000132570	ENSG00000162408	1.17e-32	101	80.198	81	20	1	3	1/3
ENSG00000131626	ENSG00000139220	0	112	83.929	94	18	3	2	3/2
ENSG00000103449	ENSG00000256463	0	163	80.368	131	32	2	1	2/1
ENSG00000099822	ENSG00000138622	0	550	90	495	55	3	2	3/2
ENSG00000099822	ENSG00000164588	0	545	85.138	464	81	3	2	3/2
ENSG00000134365	ENSG00000116785	0	191	80.105	153	38	1	3	1/3
ENSG00000129450	ENSG00000168995	0	220	85.455	188	32	2	1	2/1
ENSG00000129204	ENSG00000170832	0	779	92.94	724	55	-2	-3	-2/-3
ENSG00000033800	ENSG00000129007	0	1004	100	1004	0	1	-1	1/-1
ENSG00000129028	ENSG00000137821	4.26e-63	114	100	114	0	1	-1	1/-1
ENSG00000129028	ENSG00000137821	2.26e-55	114	100	114	0	-3	2	-3/2
ENSG00000105717	ENSG00000185630	1.81e-136	183	81.967	150	33	3	1	3/1
ENSG00000243073	ENSG00000204501	0	608	98.191	597	11	3	2	3/2
ENSG00000243073	ENSG00000239810	0	493	95.943	473	20	-1	-3	-1/-3
ENSG00000188536	ENSG00000206172	5.22e-112	178	95.506	170	8	1	2	1/2
ENSG00000126803	ENSG00000109971	0	423	88.416	374	49	2	1	2/1
ENSG00000182415	ENSG00000129873	0	651	100	651	0	-1	-2	-1/-2
ENSG00000127364	ENSG00000163807	1.5e-46	101	82.178	83	18	3	-1	3/-1
ENSG00000127364	ENSG00000163807	1.5e-46	101	82.178	83	18	-2	3	-2/3
ENSG00000127515	ENSG00000185385	8.46e-173	310	82.581	256	54	1	2	1/2
ENSG00000134049	ENSG00000267228	1.4e-80	108	98.148	106	2	-3	-1	-3/-1
ENSG00000213366	ENSG00000134184	0	385	87.532	337	48	2	3	2/3
ENSG00000213366	ENSG00000168765	0	319	83.386	266	53	3	1	3/1
ENSG00000119673	ENSG00000184227	0	304	98.355	299	5	-3	-2	-3/-2
ENSG00000187272	ENSG00000241595	4.92e-135	172	83.14	143	29	-1	-2	-1/-2
ENSG00000116455	ENSG00000116459	3.08e-70	112	97.321	109	3	-2	3	-2/3
ENSG00000117281	ENSG00000265491	1.91e-88	140	100	140	0	3	-1	3/-1
ENSG00000117281	ENSG00000265491	4.57e-83	140	100	140	0	-2	1	-2/1
ENSG00000234906	ENSG00000224916	1.1e-139	168	100	168	0	2	1	2/1
ENSG00000105613	ENSG00000086015	0	557	80.969	451	106	1	2	1/2
ENSG00000095110	ENSG00000137634	4.87e-152	217	81.567	177	40	-3	-2	-3/-2
ENSG00000130813	ENSG00000130812	4.35e-105	148	100	148	0	-1	2	-1/2
ENSG00000185479	ENSG00000170465	0	190	100	190	0	-1	-2	-1/-2
ENSG00000185479	ENSG00000205420	0	190	97.895	186	4	-1	-2	-1/-2
ENSG00000059145	ENSG00000090581	0	302	100	302	0	-2	2	-2/2
ENSG00000059145	ENSG00000090581	1.36e-177	302	100	302	0	-3	3	-3/3
ENSG00000186081	ENSG00000205420	0	355	90.141	320	35	2	1	2/1
ENSG00000186081	ENSG00000185479	0	355	90.141	320	35	2	1	2/1
ENSG00000128322	ENSG00000254709	1.79e-91	143	80.42	115	28	3	2	3/2
ENSG00000120328	ENSG00000197479	0	672	89.583	602	70	1	2	1/2
ENSG00000120328	ENSG00000120327	0	117	89.744	105	12	-3	-2	-3/-2
ENSG00000127780	ENSG00000180016	5.45e-164	192	91.667	176	16	-2	-1	-2/-1
ENSG00000129473	ENSG00000258643	1.23e-114	195	98.974	193	2	-3	-1	-3/-1
ENSG00000137273	ENSG00000103241	4.21e-66	113	96.46	109	4	1	2	1/2
ENSG00000104967	ENSG00000139910	0	228	85.526	195	33	1	3	1/3
ENSG00000136206	ENSG00000170092	5.52e-159	202	88.119	178	24	3	1	3/1
ENSG00000136206	ENSG00000205238	8.69e-164	202	86.634	175	27	3	1	3/1
ENSG00000007174	ENSG00000105877	0	323	80.805	261	62	3	2	3/2
ENSG00000198610	ENSG00000187134	1.32e-164	222	81.982	182	40	-3	-2	-3/-2
ENSG00000111249	ENSG00000257923	0	116	80.172	93	23	2	3	2/3
ENSG00000111249	ENSG00000257923	0	116	80.172	93	23	2	3	2/3
ENSG00000087299	ENSG00000162924	3.8e-108	179	84.358	151	28	3	2	3/2
ENSG00000113712	ENSG00000180138	0	335	81.194	272	63	1	3	1/3
ENSG00000113712	ENSG00000180138	0	335	81.194	272	63	3	2	3/2
ENSG00000139223	ENSG00000140350	3.26e-115	164	84.756	139	25	-1	-2	-1/-2
ENSG00000044090	ENSG00000112659	0	223	84.305	188	35	-1	-3	-1/-3
ENSG00000143995	ENSG00000134138	0	158	86.076	136	22	2	1	2/1
ENSG00000139648	ENSG00000186049	0	365	89.315	326	39	2	3	2/3
ENSG00000139648	ENSG00000170484	0	364	87.088	317	47	2	1	2/1
ENSG00000077044	ENSG00000102780	0	277	81.227	225	52	1	2	1/2
ENSG00000118094	ENSG00000019144	7.93e-157	241	100	241	0	3	-1	3/-1
ENSG00000109158	ENSG00000145863	0	334	83.533	279	55	3	2	3/2
ENSG00000138083	ENSG00000184302	2.24e-131	210	86.667	182	28	1	2	1/2
ENSG00000139725	ENSG00000188735	0	581	100	581	0	-1	3	-1/3
ENSG00000081181	ENSG00000100568	0	256	100	256	0	-3	3	-3/3
ENSG00000081181	ENSG00000100568	0	256	100	256	0	1	-1	1/-1
ENSG00000135587	ENSG00000185250	3.33e-73	136	100	136	0	-1	1	-1/1
ENSG00000135587	ENSG00000185250	3.33e-73	136	100	136	0	-1	1	-1/1
ENSG00000181381	ENSG00000137628	0	150	80.667	121	29	3	2	3/2
ENSG00000138109	ENSG00000165841	0	513	88.499	454	59	3	1	3/1
ENSG00000138109	ENSG00000108242	0	484	81.818	396	88	1	2	1/2
ENSG00000085563	ENSG00000005471	0	532	83.083	442	90	2	1	2/1
ENSG00000143226	ENSG00000072694	0	191	89.005	170	21	-1	-3	-1/-3
ENSG00000187122	ENSG00000145147	0	212	83.491	177	35	1	2	1/2
ENSG00000005339	ENSG00000100393	0	471	90.446	426	45	1	2	1/2
ENSG00000100902	ENSG00000258790	1.25e-169	248	100	248	0	1	3	1/3
ENSG00000135945	ENSG00000158417	3.61e-180	284	100	284	0	3	-1	3/-1
ENSG00000126583	ENSG00000154229	0	146	80.137	117	29	1	3	1/3
ENSG00000126583	ENSG00000166501	0	146	81.507	119	27	1	3	1/3
ENSG00000072315	ENSG00000133107	0	270	80.741	218	52	2	1	2/1
ENSG00000072315	ENSG00000133107	0	270	80.741	218	52	2	1	2/1
ENSG00000196943	ENSG00000136305	0	213	99.531	212	1	2	-2	2/-2
ENSG00000137285	ENSG00000137267	0	428	98.832	423	5	-3	-1	-3/-1
ENSG00000137285	ENSG00000104833	0	438	86.986	381	57	-3	-1	-3/-1
ENSG00000139625	ENSG00000197111	0	497	100	497	0	-2	2	-2/2
ENSG00000139625	ENSG00000197111	0	497	100	497	0	-2	1	-2/1
ENSG00000113504	ENSG00000124140	0	548	81.204	445	103	3	2	3/2
ENSG00000113504	ENSG00000124140	0	548	81.204	445	103	3	2	3/2
ENSG00000136698	ENSG00000152093	0	250	99.6	249	1	3	1	3/1
ENSG00000138685	ENSG00000170917	5.27e-138	196	98.98	194	2	2	-2	2/-2
ENSG00000137880	ENSG00000104129	6.83e-129	161	100	161	0	2	-2	2/-2
ENSG00000137880	ENSG00000104129	1.98e-122	161	100	161	0	-1	3	-1/3
ENSG00000137880	ENSG00000104129	1.61e-116	161	100	161	0	1	-1	1/-1
ENSG00000102753	ENSG00000186432	0	523	85.851	449	74	2	1	2/1
ENSG00000142178	ENSG00000275993	0	429	99.301	426	3	-1	-3	-1/-3
ENSG00000137766	ENSG00000198722	0	409	82.885	339	70	1	2	1/2
ENSG00000121594	ENSG00000113845	9.89e-160	266	100	266	0	-1	1	-1/1
ENSG00000140521	ENSG00000140525	2.3e-83	155	94.194	146	9	1	-1	1/-1
ENSG00000104833	ENSG00000188229	0	274	98.54	270	4	1	2	1/2
ENSG00000104833	ENSG00000196230	3.44e-168	112	88.393	99	13	-1	-2	-1/-2
ENSG00000122481	ENSG00000271092	1.28e-115	170	99.412	169	1	2	1	2/1
ENSG00000144136	ENSG00000168575	0	203	81.281	165	38	3	2	3/2
ENSG00000144136	ENSG00000168575	0	203	81.281	165	38	3	2	3/2
ENSG00000129159	ENSG00000131398	4.72e-139	201	81.592	164	37	-2	-3	-2/-3
ENSG00000083844	ENSG00000204524	0	511	85.519	437	74	1	3	1/3
ENSG00000072133	ENSG00000177189	0	295	86.102	254	41	3	2	3/2
ENSG00000076067	ENSG00000144642	1.02e-159	196	84.184	165	31	3	2	3/2
ENSG00000205045	ENSG00000172123	0	360	81.389	293	67	2	3	2/3
ENSG00000139946	ENSG00000197329	0	411	81.752	336	75	2	3	2/3
ENSG00000081019	ENSG00000187257	0	363	82.369	299	64	2	1	2/1
ENSG00000136240	ENSG00000105438	1.05e-123	213	83.568	178	35	3	1	3/1
ENSG00000141232	ENSG00000183864	1.74e-82	121	80.165	97	24	1	3	1/3
ENSG00000105464	ENSG00000161509	0	418	83.493	349	69	2	1	2/1
ENSG00000136231	ENSG00000156928	0	506	100	506	0	2	-3	2/-3
ENSG00000136231	ENSG00000159217	0	188	80.319	151	37	1	2	1/2
ENSG00000136379	ENSG00000129968	2.42e-152	240	82.917	199	41	2	3	2/3
ENSG00000146216	ENSG00000128881	0	317	81.073	257	60	3	2	3/2
ENSG00000143954	ENSG00000172016	4.89e-127	215	84.651	182	33	-3	-2	-3/-2
ENSG00000100764	ENSG00000119720	0	567	99.471	564	3	3	-3	3/-3
ENSG00000121454	ENSG00000107187	1.23e-138	127	80.315	102	25	2	3	2/3
ENSG00000105402	ENSG00000125814	4.73e-156	292	84.247	246	46	1	3	1/3
ENSG00000083750	ENSG00000155876	0	273	97.802	267	6	3	2	3/2
ENSG00000108963	ENSG00000262664	2.68e-168	231	100	231	0	2	1	2/1
ENSG00000119614	ENSG00000100987	3.09e-60	115	80	92	23	1	3	1/3
ENSG00000082701	ENSG00000105723	0	363	83.747	304	59	3	2	3/2
ENSG00000115112	ENSG00000135457	0	250	84.8	212	38	3	1	3/1
ENSG00000115112	ENSG00000153560	0	243	83.539	203	40	3	1	3/1
ENSG00000136536	ENSG00000241399	0	613	100	613	0	2	-3	2/-3
ENSG00000136536	ENSG00000241399	0	613	100	613	0	2	-3	2/-3
ENSG00000135144	ENSG00000110042	0	183	82.514	151	32	3	2	3/2
ENSG00000139133	ENSG00000175548	4.09e-95	187	85.027	159	28	1	3	1/3
ENSG00000116017	ENSG00000179361	7.22e-100	138	83.333	115	23	3	1	3/1
ENSG00000116017	ENSG00000179361	1.25e-96	138	83.333	115	23	3	2	3/2
ENSG00000139266	ENSG00000144583	9.53e-99	159	90.566	144	15	3	1	3/1
ENSG00000141437	ENSG00000122696	0	311	93.248	290	21	3	2	3/2
ENSG00000099308	ENSG00000086015	0	359	83.844	301	58	1	2	1/2
ENSG00000099308	ENSG00000105613	0	202	83.168	168	34	-3	-2	-3/-2
ENSG00000107282	ENSG00000034053	0	347	83.862	291	56	2	3	2/3
ENSG00000107282	ENSG00000034053	0	347	83.862	291	56	2	1	2/1
ENSG00000133026	ENSG00000133392	0	981	81.957	804	177	2	3	2/3
ENSG00000133026	ENSG00000133392	0	981	81.957	804	177	2	3	2/3
ENSG00000135452	ENSG00000135446	5.59e-114	168	100	168	0	1	-2	1/-2
ENSG00000135452	ENSG00000135446	7.1e-105	168	100	168	0	3	-1	3/-1
ENSG00000183668	ENSG00000221826	0	448	87.277	391	57	2	3	2/3
ENSG00000183668	ENSG00000243137	0	446	86.771	387	59	-2	-3	-2/-3
ENSG00000119048	ENSG00000077721	3e-98	158	93.038	147	11	1	3	1/3
ENSG00000143878	ENSG00000067560	2.61e-109	186	86.559	161	25	3	2	3/2
ENSG00000143878	ENSG00000155366	2.61e-109	182	88.462	161	21	3	2	3/2
ENSG00000126814	ENSG00000198830	1.41e-156	183	85.246	156	27	2	1	2/1
ENSG00000126814	ENSG00000198830	2.19e-157	183	85.246	156	27	2	3	2/3
ENSG00000102882	ENSG00000100030	0	345	88.116	304	41	2	1	2/1
ENSG00000102882	ENSG00000100030	0	345	88.116	304	41	2	1	2/1
ENSG00000143933	ENSG00000160014	4.47e-98	153	99.346	152	1	3	2	3/2
ENSG00000126934	ENSG00000169032	0	228	92.544	211	17	3	1	3/1
ENSG00000091664	ENSG00000104888	0	512	82.422	422	90	3	2	3/2
ENSG00000141385	ENSG00000176014	1.39e-149	213	100	213	0	1	-1	1/-1
ENSG00000141385	ENSG00000176014	3.92e-146	213	100	213	0	-3	2	-3/2
ENSG00000115239	ENSG00000270898	0	593	99.325	589	4	3	1	3/1
ENSG00000109181	ENSG00000171234	0	556	83.273	463	93	3	1	3/1
ENSG00000109181	ENSG00000213759	0	495	89.697	444	51	-1	-2	-1/-2
ENSG00000145002	ENSG00000186523	0	309	99.676	308	1	-1	-2	-1/-2
ENSG00000137801	ENSG00000186340	0	261	83.142	217	44	1	3	1/3
ENSG00000137801	ENSG00000186340	0	261	83.142	217	44	1	2	1/2
ENSG00000103061	ENSG00000103064	0	977	100	977	0	2	-3	2/-3
ENSG00000103061	ENSG00000103064	0	977	100	977	0	2	-3	2/-3
ENSG00000137822	ENSG00000067369	1.69e-106	137	91.971	126	11	-2	1	-2/1
ENSG00000143867	ENSG00000164920	2.3e-109	103	92.233	95	8	1	2	1/2
ENSG00000143867	ENSG00000164920	2.3e-109	103	92.233	95	8	1	2	1/2
ENSG00000069956	ENSG00000141639	1.5e-145	180	80.556	145	35	1	2	1/2
ENSG00000104388	ENSG00000129472	3.69e-115	191	90.052	172	19	1	3	1/3
ENSG00000165055	ENSG00000087995	0	458	95.633	438	20	1	3	1/3
ENSG00000144118	ENSG00000006451	1.34e-69	126	89.683	113	13	1	3	1/3
ENSG00000243709	ENSG00000143768	0	399	94.486	377	22	3	2	3/2
ENSG00000135175	ENSG00000122543	2.3e-153	231	98.268	227	4	-1	-3	-1/-3
ENSG00000110013	ENSG00000154144	0	562	100	562	0	-3	1	-3/1
ENSG00000138031	ENSG00000138092	0	257	99.222	255	2	-2	1	-2/1
ENSG00000135018	ENSG00000188021	0	163	90.184	147	16	1	2	1/2
ENSG00000084731	ENSG00000101350	0	115	82.609	95	20	2	3	2/3
ENSG00000114166	ENSG00000108773	0	252	81.349	205	47	3	1	3/1
ENSG00000089116	ENSG00000273706	5.93e-159	118	92.373	109	9	2	1	2/1
ENSG00000089558	ENSG00000183960	0	224	81.696	183	41	1	3	1/3
ENSG00000109220	ENSG00000204116	3.18e-73	148	83.108	123	25	1	3	1/3
ENSG00000138741	ENSG00000069018	0	422	84.123	355	67	3	2	3/2
ENSG00000064651	ENSG00000074803	0	184	82.065	151	33	1	3	1/3
ENSG00000113319	ENSG00000058335	0	319	85.266	272	47	2	3	2/3
ENSG00000113319	ENSG00000058335	0	319	85.266	272	47	2	3	2/3
ENSG00000066027	ENSG00000154001	0	284	85.915	244	40	2	3	2/3
ENSG00000077232	ENSG00000174749	0	152	80.921	123	29	-1	-3	-1/-3
ENSG00000143862	ENSG00000134108	1.64e-115	183	91.257	167	16	2	3	2/3
ENSG00000141965	ENSG00000145780	0	115	83.478	96	19	1	2	1/2
ENSG00000138079	ENSG00000138078	0	417	99.76	416	1	-1	3	-1/3
ENSG00000138079	ENSG00000138078	0	417	99.76	416	1	-1	2	-1/2
ENSG00000135100	ENSG00000157895	0	474	100	474	0	3	-1	3/-1
ENSG00000064726	ENSG00000133243	0	379	84.697	321	58	3	1	3/1
ENSG00000123124	ENSG00000198373	0	453	81.457	369	84	2	3	2/3
ENSG00000007047	ENSG00000075413	0	335	85.97	288	47	2	1	2/1
ENSG00000139278	ENSG00000111615	0	379	99.736	378	1	2	-2	2/-2
ENSG00000113721	ENSG00000134853	0	154	80.519	124	30	3	2	3/2
ENSG00000105610	ENSG00000136826	9.01e-58	104	80.769	84	20	3	1	3/1
ENSG00000127412	ENSG00000165125	1.25e-148	193	84.974	164	29	1	3	1/3
ENSG00000127412	ENSG00000165125	5.34e-148	193	84.974	164	29	1	3	1/3
ENSG00000137040	ENSG00000065150	0	877	82.326	722	155	3	1	3/1
ENSG00000089902	ENSG00000117625	5.09e-139	129	83.721	108	21	2	3	2/3
ENSG00000089902	ENSG00000117625	7.13e-139	129	83.721	108	21	2	3	2/3
ENSG00000144119	ENSG00000165985	1.2e-92	132	88.636	117	15	3	2	3/2
ENSG00000141429	ENSG00000144278	0	505	85.941	434	71	2	1	2/1
ENSG00000135097	ENSG00000153944	2.1e-134	175	85.714	150	25	3	1	3/1
ENSG00000120658	ENSG00000165675	0	159	84.277	134	25	3	2	3/2
ENSG00000120658	ENSG00000165675	0	159	84.277	134	25	3	2	3/2
ENSG00000135443	ENSG00000170523	0	299	91.639	274	25	2	1	2/1
ENSG00000135443	ENSG00000170442	1.02e-172	179	90.503	162	17	-3	-1	-3/-1
ENSG00000007384	ENSG00000129667	0	208	80.288	167	41	3	2	3/2
ENSG00000100393	ENSG00000005339	0	490	88.163	432	58	2	1	2/1
ENSG00000100393	ENSG00000005339	0	490	88.163	432	58	2	1	2/1
ENSG00000138622	ENSG00000099822	0	562	88.612	498	64	2	3	2/3
ENSG00000139112	ENSG00000170296	1.39e-68	116	87.069	101	15	2	3	2/3
ENSG00000136842	ENSG00000136925	0	555	100	555	0	-1	3	-1/3
ENSG00000112246	ENSG00000159263	0	359	86.072	309	50	3	2	3/2
ENSG00000116254	ENSG00000111642	0	349	86.533	302	47	2	3	2/3
ENSG00000116254	ENSG00000111642	0	349	86.533	302	47	2	3	2/3
ENSG00000103740	ENSG00000166411	0	870	100	870	0	-1	1	-1/1
ENSG00000240303	ENSG00000081307	0	294	99.66	293	1	-1	3	-1/3
ENSG00000116489	ENSG00000198898	1.19e-164	288	86.806	250	38	1	2	1/2
ENSG00000105808	ENSG00000170667	0	632	99.525	629	3	3	2	3/2
ENSG00000047457	ENSG00000163755	0	411	100	411	0	2	-1	2/-1
ENSG00000139180	ENSG00000003402	4.1e-139	198	91.414	181	17	-1	-3	-1/-3
ENSG00000139180	ENSG00000175387	1.12e-150	204	86.275	176	28	-2	-3	-2/-3
ENSG00000136682	ENSG00000172785	0	597	98.66	589	8	-1	-2	-1/-2
ENSG00000136682	ENSG00000196873	0	597	97.99	585	12	-1	-2	-1/-2
ENSG00000138758	ENSG00000125354	0	343	86.006	295	48	1	2	1/2
ENSG00000111700	ENSG00000205754	0	220	83.636	184	36	-1	-3	-1/-3
ENSG00000121879	ENSG00000171121	0	775	100	775	0	-3	3	-3/3
ENSG00000103241	ENSG00000137273	1.65e-68	127	90.551	115	12	2	1	2/1
ENSG00000115317	ENSG00000115318	2.28e-132	178	99.438	177	1	1	-3	1/-3
ENSG00000135414	ENSG00000205323	4.16e-82	127	100	127	0	-2	3	-2/3
ENSG00000135414	ENSG00000205323	7.85e-82	127	100	127	0	2	-1	2/-1
ENSG00000130511	ENSG00000157216	3.48e-151	133	82.707	110	23	1	3	1/3
ENSG00000067113	ENSG00000039123	4.27e-101	160	100	160	0	-2	1	-2/1
ENSG00000067113	ENSG00000039123	2.09e-100	160	100	160	0	2	-2	2/-2
ENSG00000067113	ENSG00000039123	1.93e-99	160	100	160	0	3	-3	3/-3
ENSG00000118620	ENSG00000197020	0	591	80.88	478	113	-1	-2	-1/-2
ENSG00000118620	ENSG00000196705	0	104	81.731	85	19	2	1	2/1
ENSG00000100815	ENSG00000066427	6.09e-113	170	100	170	0	-2	-3	-2/-3
ENSG00000055118	ENSG00000184611	0	266	88.346	235	31	1	2	1/2
ENSG00000142611	ENSG00000085276	0	190	85.789	163	27	2	3	2/3
ENSG00000107341	ENSG00000099804	5.82e-120	196	86.735	170	26	3	2	3/2
ENSG00000213064	ENSG00000162924	4.18e-162	100	80	80	20	-3	3	-3/3
ENSG00000213064	ENSG00000173597	0	108	80.556	87	21	-1	-3	-1/-3
ENSG00000111684	ENSG00000126749	0	238	99.16	236	2	-1	3	-1/3
ENSG00000263155	ENSG00000137878	0	502	99.602	500	2	1	2	1/2
ENSG00000128881	ENSG00000146216	0	314	81.529	256	58	2	3	2/3
ENSG00000134853	ENSG00000113721	0	152	81.579	124	28	2	3	2/3
ENSG00000117971	ENSG00000160716	0	283	80.212	227	56	2	1	2/1
ENSG00000047662	ENSG00000118579	0	1107	100	1107	0	-1	3	-1/3
ENSG00000087302	ENSG00000087303	0	236	98.729	233	3	-1	3	-1/3
ENSG00000242019	ENSG00000240403	0	123	82.114	101	22	-1	-3	-1/-3
ENSG00000174460	ENSG00000166707	0	285	86.316	246	39	1	2	1/2
ENSG00000137076	ENSG00000171914	0	394	80.457	317	77	1	3	1/3
ENSG00000170917	ENSG00000138685	8.38e-139	196	98.98	194	2	-2	2	-2/2
ENSG00000140905	ENSG00000023228	3.89e-167	136	88.971	121	15	3	2	3/2
ENSG00000159251	ENSG00000143632	0	378	98.942	374	4	3	2	3/2
ENSG00000159251	ENSG00000107796	0	388	96.907	376	12	3	1	3/1
ENSG00000148943	ENSG00000104863	1.89e-100	204	82.353	168	36	1	3	1/3
ENSG00000148943	ENSG00000111052	5.32e-93	191	80.628	154	37	1	3	1/3
ENSG00000164620	ENSG00000197948	0	136	100	136	0	-2	2	-2/2
ENSG00000144566	ENSG00000108774	1.6e-122	212	87.736	186	26	3	2	3/2
ENSG00000154710	ENSG00000284461	0	878	100	878	0	-2	-3	-2/-3
ENSG00000176692	ENSG00000054598	6.95e-97	122	89.344	109	13	2	1	2/1
ENSG00000146083	ENSG00000137075	4.86e-147	118	84.746	100	18	1	3	1/3
ENSG00000150593	ENSG00000214413	0	425	100	425	0	-3	2	-3/2
ENSG00000150593	ENSG00000214413	0	425	100	425	0	-2	1	-2/1
ENSG00000150593	ENSG00000214413	0	425	100	425	0	3	-3	3/-3
ENSG00000172939	ENSG00000198648	0	338	83.728	283	55	1	2	1/2
ENSG00000145020	ENSG00000283189	0	388	100	388	0	-2	-3	-2/-3
ENSG00000168569	ENSG00000185475	1.84e-85	145	100	145	0	-1	1	-1/1
ENSG00000166664	ENSG00000175344	0	463	99.784	462	1	3	1	3/1
ENSG00000148136	ENSG00000204246	5.88e-176	317	83.912	266	51	1	2	1/2
ENSG00000206172	ENSG00000188536	4.91e-112	178	95.506	170	8	2	1	2/1
ENSG00000142789	ENSG00000219073	2.07e-180	295	93.898	277	18	-3	-1	-3/-1
ENSG00000182793	ENSG00000243955	9.08e-143	253	84.585	214	39	-1	-2	-1/-2
ENSG00000173908	ENSG00000171446	0	331	85.196	282	49	1	3	1/3
ENSG00000173908	ENSG00000204897	0	331	84.894	281	50	1	2	1/2
ENSG00000160014	ENSG00000198668	6.41e-99	173	90.751	157	16	2	3	2/3
ENSG00000160014	ENSG00000143933	8.61e-98	153	99.346	152	1	2	3	2/3
ENSG00000181788	ENSG00000196470	6.58e-151	202	87.129	176	26	1	3	1/3
ENSG00000181788	ENSG00000196470	6.59e-151	202	87.129	176	26	1	3	1/3
ENSG00000177186	ENSG00000228198	0	313	91.693	287	26	1	2	1/2
ENSG00000171497	ENSG00000171503	3.16e-111	163	100	163	0	-1	3	-1/3
ENSG00000171497	ENSG00000171503	4.7e-108	163	100	163	0	2	-1	2/-1
ENSG00000171497	ENSG00000171503	2.92e-106	163	100	163	0	-2	1	-2/1
ENSG00000171497	ENSG00000171503	3.42e-92	163	100	163	0	3	-2	3/-2
ENSG00000152086	ENSG00000075886	0	288	96.181	277	11	-2	-3	-2/-3
ENSG00000152086	ENSG00000198033	0	438	98.174	430	8	3	1	3/1
ENSG00000166503	ENSG00000136404	0	312	99.359	310	2	-2	3	-2/3
ENSG00000181767	ENSG00000181693	0	351	85.755	301	50	2	3	2/3
ENSG00000177151	ENSG00000196240	0	221	100	221	0	1	2	1/2
ENSG00000179981	ENSG00000121297	0	148	85.135	126	22	3	2	3/2
ENSG00000267631	ENSG00000104818	1.67e-112	169	98.817	167	2	1	2	1/2
ENSG00000267631	ENSG00000213030	1.45e-84	129	100	129	0	-2	-1	-2/-1
ENSG00000176679	ENSG00000153779	9.46e-127	197	92.893	183	14	-1	-2	-1/-2
ENSG00000170442	ENSG00000205426	0	419	99.045	415	4	2	1	2/1
ENSG00000169750	ENSG00000128340	5e-116	200	86.5	173	27	1	3	1/3
ENSG00000125944	ENSG00000135316	0	404	84.406	341	63	2	1	2/1
ENSG00000170950	ENSG00000102144	0	405	87.16	353	52	1	3	1/3
ENSG00000075886	ENSG00000152086	0	330	97.576	322	8	-3	-2	-3/-2
ENSG00000075886	ENSG00000198033	0	439	99.089	435	4	3	1	3/1
ENSG00000167977	ENSG00000180901	3.13e-106	162	83.951	136	26	3	1	3/1
ENSG00000152484	ENSG00000109189	0	358	88.827	318	40	3	2	3/2
ENSG00000213413	ENSG00000121716	6.94e-150	248	95.161	236	12	1	3	1/3
ENSG00000175279	ENSG00000251503	1.8e-94	176	100	176	0	1	3	1/3
ENSG00000170027	ENSG00000128245	4.93e-135	235	87.66	206	29	2	1	2/1
ENSG00000166947	ENSG00000166946	0	361	100	361	0	1	-3	1/-3
ENSG00000164438	ENSG00000107807	1.62e-81	143	80.42	115	28	2	3	2/3
ENSG00000128655	ENSG00000284741	0	578	100	578	0	-2	-3	-2/-3
ENSG00000152253	ENSG00000221947	6.3e-91	110	89.091	98	12	2	1	2/1
ENSG00000145736	ENSG00000183474	0	571	98.949	565	6	-2	-1	-2/-1
ENSG00000171942	ENSG00000172519	0	316	87.658	277	39	-2	-1	-2/-1
ENSG00000165389	ENSG00000165633	1.92e-47	100	80	80	20	-3	3	-3/3
ENSG00000166147	ENSG00000138829	0	319	80.564	257	62	1	2	1/2
ENSG00000171291	ENSG00000171295	0	353	82.153	290	63	-1	-2	-1/-2
ENSG00000171234	ENSG00000109181	0	558	87.455	488	70	2	1	2/1
ENSG00000171234	ENSG00000213759	0	563	85.08	479	84	2	1	2/1
ENSG00000168961	ENSG00000171916	0	322	94.72	305	17	2	1	2/1
ENSG00000145780	ENSG00000141965	0	115	83.478	96	19	2	1	2/1
ENSG00000152439	ENSG00000105136	0	410	89.756	368	42	-2	-1	-2/-1
ENSG00000167004	ENSG00000128886	3.86e-124	210	100	210	0	3	-1	3/-1
ENSG00000146707	ENSG00000272391	1.11e-67	134	93.284	125	9	2	3	2/3
ENSG00000179142	ENSG00000160882	0	416	92.788	386	30	-1	-2	-1/-2
ENSG00000005022	ENSG00000169100	0	304	90.461	275	29	3	2	3/2
ENSG00000005022	ENSG00000151729	1.67e-176	299	88.963	266	33	3	1	3/1
ENSG00000173041	ENSG00000198039	0	207	82.126	170	37	-1	-2	-1/-2
ENSG00000164729	ENSG00000259224	0	553	93.49	517	36	3	2	3/2
ENSG00000164729	ENSG00000177710	0	380	93.684	356	24	-1	-2	-1/-2
ENSG00000170484	ENSG00000139648	0	361	86.981	314	47	1	2	1/2
ENSG00000170484	ENSG00000186049	0	361	86.427	312	49	1	3	1/3
ENSG00000180340	ENSG00000155760	0	387	80.362	311	76	3	2	3/2
ENSG00000180340	ENSG00000157240	0	309	85.113	263	46	3	2	3/2
ENSG00000145107	ENSG00000273331	3.63e-163	218	100	218	0	-1	-3	-1/-3
ENSG00000163064	ENSG00000164778	1.34e-65	125	84.8	106	19	2	1	2/1
ENSG00000166501	ENSG00000154229	0	294	87.075	256	38	2	3	2/3
ENSG00000177879	ENSG00000157823	9.06e-109	192	84.375	162	30	3	1	3/1
ENSG00000146411	ENSG00000028839	0	463	100	463	0	-2	1	-2/1
ENSG00000180871	ENSG00000163464	6.52e-146	305	82.623	252	53	-3	-2	-3/-2
ENSG00000180481	ENSG00000106460	4.47e-72	109	81.651	89	20	-2	-1	-2/-1
ENSG00000174233	ENSG00000173175	0	359	82.73	297	62	3	2	3/2
ENSG00000158164	ENSG00000158427	3.66e-99	109	86.239	94	15	1	3	1/3
ENSG00000158164	ENSG00000158427	1.19e-97	109	86.239	94	15	-3	-2	-3/-2
ENSG00000239605	ENSG00000273269	7.2e-127	185	100	185	0	-2	-3	-2/-3
ENSG00000239605	ENSG00000273269	1.59e-124	185	100	185	0	1	2	1/2
ENSG00000172468	ENSG00000169953	8.72e-135	205	98.537	202	3	-1	-2	-1/-2
ENSG00000181541	ENSG00000180660	0	386	92.746	358	28	2	1	2/1
ENSG00000150977	ENSG00000182070	0	166	80.12	133	33	-3	2	-3/2
ENSG00000150977	ENSG00000172828	3.39e-154	163	80.982	132	31	3	2	3/2
ENSG00000167657	ENSG00000196730	2.99e-144	212	84.434	179	33	1	3	1/3
ENSG00000103335	ENSG00000154864	0	173	83.815	145	28	2	1	2/1
ENSG00000158714	ENSG00000188004	0	327	99.388	325	2	-1	2	-1/2
ENSG00000048828	ENSG00000184083	0	220	80	176	44	3	1	3/1
ENSG00000163623	ENSG00000148826	6.92e-86	113	83.186	94	19	1	3	1/3
ENSG00000089012	ENSG00000101307	0	338	80.769	273	65	-3	-2	-3/-2
ENSG00000177889	ENSG00000173598	0	395	100	395	0	2	-3	2/-3
ENSG00000204983	ENSG00000275896	1.45e-129	264	87.5	231	33	-1	-2	-1/-2
ENSG00000204983	ENSG00000010438	2.16e-126	266	84.586	225	41	-1	-2	-1/-2
ENSG00000154025	ENSG00000154016	0	494	99.595	492	2	3	-1	3/-1
ENSG00000087995	ENSG00000165055	0	452	96.239	435	17	3	1	3/1
ENSG00000162924	ENSG00000196911	0	395	93.418	369	26	1	2	1/2
ENSG00000173281	ENSG00000231925	4.53e-84	101	81.188	82	19	2	-1	2/-1
ENSG00000243130	ENSG00000242221	0	440	89.318	393	47	3	1	3/1
ENSG00000184716	ENSG00000140264	0	296	96.622	286	10	2	-2	2/-2
ENSG00000103942	ENSG00000152413	6.3e-101	132	81.818	108	24	2	1	2/1
ENSG00000256713	ENSG00000229183	0	506	99.407	503	3	-1	-2	-1/-2
ENSG00000256713	ENSG00000229859	0	506	99.012	501	5	-1	-2	-1/-2
ENSG00000157326	ENSG00000187630	0	235	91.064	214	21	3	1	3/1
ENSG00000160339	ENSG00000085265	1.03e-162	219	84.018	184	35	2	3	2/3
ENSG00000157240	ENSG00000155760	0	133	85.714	114	19	-1	-2	-1/-2
ENSG00000157240	ENSG00000180340	0	309	85.113	263	46	2	3	2/3
ENSG00000149289	ENSG00000102053	0	258	83.333	215	43	1	2	1/2
ENSG00000149289	ENSG00000163874	1.17e-138	209	82.775	173	36	1	3	1/3
ENSG00000174437	ENSG00000196296	0	508	86.811	441	67	3	2	3/2
ENSG00000013016	ENSG00000110047	0	532	87.03	463	69	1	3	1/3
ENSG00000243232	ENSG00000204967	0	658	100	658	0	1	3	1/3
ENSG00000243232	ENSG00000081842	0	658	100	658	0	1	3	1/3
ENSG00000062582	ENSG00000270617	4.1e-140	203	99.507	202	1	3	1	3/1
ENSG00000177363	ENSG00000198625	1.45e-82	100	83	83	17	-1	2	-1/2
ENSG00000177363	ENSG00000198625	1.45e-82	100	83	83	17	-1	1	-1/1
ENSG00000163114	ENSG00000131828	0	376	86.436	325	51	1	2	1/2
ENSG00000112232	ENSG00000131773	6.88e-110	136	82.353	112	24	1	3	1/3
ENSG00000159556	ENSG00000016082	2.71e-174	188	81.383	153	35	2	3	2/3
ENSG00000146049	ENSG00000146038	6.54e-124	199	99.497	198	1	-3	2	-3/2
ENSG00000170523	ENSG00000170442	0	410	98.293	403	7	1	2	1/2
ENSG00000168374	ENSG00000143761	4.98e-98	180	81.111	146	34	2	1	2/1
ENSG00000171735	ENSG00000108509	0	163	85.276	139	24	1	2	1/2
ENSG00000270316	ENSG00000214435	0	753	99.602	750	3	2	3	2/3
ENSG00000270316	ENSG00000166275	3.34e-93	115	99.13	114	1	1	2	1/2
ENSG00000171489	ENSG00000171478	6.43e-119	170	100	170	0	3	1	3/1
ENSG00000171489	ENSG00000171478	6.97e-112	170	100	170	0	1	2	1/2
ENSG00000166529	ENSG00000166526	0	296	99.662	295	1	-3	2	-3/2
ENSG00000065665	ENSG00000058262	0	477	93.501	446	31	3	2	3/2
ENSG00000163286	ENSG00000163283	0	488	97.746	477	11	2	3	2/3
ENSG00000163286	ENSG00000163295	0	516	85.659	442	74	-1	-3	-1/-3
ENSG00000163126	ENSG00000213337	0	496	100	496	0	1	3	1/3
ENSG00000101210	ENSG00000156508	0	226	82.301	186	40	-2	-3	-2/-3
ENSG00000178363	ENSG00000160014	5.35e-84	158	81.646	129	29	1	2	1/2
ENSG00000177462	ENSG00000177212	0	312	93.59	292	20	1	2	1/2
ENSG00000189306	ENSG00000183569	3.19e-78	128	95.312	122	6	-2	3	-2/3
ENSG00000172969	ENSG00000205097	0	355	94.366	335	20	-2	-3	-2/-3
ENSG00000174628	ENSG00000167191	0	592	100	592	0	-2	3	-2/3
ENSG00000161202	ENSG00000004975	0	131	91.603	120	11	3	2	3/2
ENSG00000161202	ENSG00000107404	0	132	82.576	109	23	3	1	3/1
ENSG00000163322	ENSG00000163319	0	394	99.746	393	1	2	-2	2/-2
ENSG00000060971	ENSG00000008226	2.85e-88	143	97.902	140	3	2	-1	2/-1
ENSG00000147223	ENSG00000165376	4.3e-65	121	95.041	115	6	2	-2	2/-2
ENSG00000164032	ENSG00000105968	1.85e-65	130	80.769	105	25	-1	-2	-1/-2
ENSG00000164934	ENSG00000164933	2.13e-49	108	99.074	107	1	1	-2	1/-2
ENSG00000171150	ENSG00000180008	2.22e-124	168	84.524	142	26	2	3	2/3
ENSG00000176809	ENSG00000238083	0	1190	97.563	1161	29	2	1	2/1
ENSG00000243444	ENSG00000157654	9.04e-104	183	99.454	182	1	3	1	3/1
ENSG00000171989	ENSG00000166800	0	341	82.698	282	59	2	1	2/1
ENSG00000171989	ENSG00000166800	0	341	82.698	282	59	2	3	2/3
ENSG00000132334	ENSG00000132670	0	122	83.607	102	20	2	1	2/1
ENSG00000140525	ENSG00000140521	3.89e-81	153	94.118	144	9	-1	3	-1/3
ENSG00000179172	ENSG00000275774	1.19e-160	261	96.169	251	10	-1	-3	-1/-3
ENSG00000179172	ENSG00000277058	6.17e-157	261	95.019	248	13	-1	-3	-1/-3
ENSG00000101335	ENSG00000118680	3.19e-101	154	93.506	144	10	3	1	3/1
ENSG00000175077	ENSG00000198471	7.42e-100	169	89.349	151	18	-2	-1	-2/-1
ENSG00000186049	ENSG00000139648	0	365	89.315	326	39	3	2	3/2
ENSG00000186049	ENSG00000170484	0	364	86.538	315	49	3	1	3/1
ENSG00000166800	ENSG00000171989	0	332	82.229	273	59	3	2	3/2
ENSG00000169564	ENSG00000197111	0	176	92.614	163	13	3	2	3/2
ENSG00000179615	ENSG00000179626	1.18e-141	139	82.014	114	25	1	2	1/2
ENSG00000173166	ENSG00000138443	0	1164	100	1164	0	-1	2	-1/2
ENSG00000134184	ENSG00000213366	0	183	92.896	170	13	1	3	1/3
ENSG00000166363	ENSG00000170790	0	342	92.105	315	27	-2	-3	-2/-3
ENSG00000115073	ENSG00000138107	4.86e-160	187	85.027	159	28	-3	-1	-3/-1
ENSG00000174279	ENSG00000106038	2.01e-80	107	88.785	95	12	3	2	3/2
ENSG00000164256	ENSG00000126856	0	225	93.778	211	14	3	2	3/2
ENSG00000160469	ENSG00000174672	0	264	93.561	247	17	2	1	2/1
ENSG00000160469	ENSG00000174672	0	264	93.561	247	17	2	1	2/1
ENSG00000146574	ENSG00000169402	4.07e-88	134	100	134	0	-3	1	-3/1
ENSG00000169925	ENSG00000204256	0	115	86.087	99	16	1	3	1/3
ENSG00000128886	ENSG00000167004	2.38e-124	210	100	210	0	-1	3	-1/3
ENSG00000128886	ENSG00000140264	5.73e-87	147	93.197	137	10	-1	1	-1/1
ENSG00000239961	ENSG00000204577	1e-168	142	81.69	116	26	3	2	3/2
ENSG00000239961	ENSG00000204577	2.11e-166	142	81.69	116	26	3	2	3/2
ENSG00000169592	ENSG00000149929	2.74e-144	226	99.558	225	1	-1	2	-1/2
ENSG00000124467	ENSG00000231924	0	480	88.958	427	53	2	3	2/3
ENSG00000102034	ENSG00000120690	4.33e-90	116	86.207	100	16	3	1	3/1
ENSG00000221866	ENSG00000076356	0	726	81.818	594	132	2	3	2/3
ENSG00000166803	ENSG00000259316	4.9e-90	146	100	146	0	1	3	1/3
ENSG00000166803	ENSG00000259316	1.38e-86	146	100	146	0	2	1	2/1
ENSG00000166803	ENSG00000259316	1.09e-83	146	100	146	0	-3	-2	-3/-2
ENSG00000166803	ENSG00000259316	1.89e-70	146	100	146	0	-1	-3	-1/-3
ENSG00000167618	ENSG00000167613	2.75e-85	145	81.379	118	27	3	1	3/1
ENSG00000165457	ENSG00000110203	3.61e-147	212	87.736	186	26	2	3	2/3
ENSG00000165238	ENSG00000196632	0	242	93.388	226	16	1	2	1/2
ENSG00000160993	ENSG00000160991	8.16e-133	194	100	194	0	-1	1	-1/1
ENSG00000160993	ENSG00000160991	8.16e-133	194	100	194	0	-1	1	-1/1
ENSG00000164346	ENSG00000164347	3.46e-82	127	98.425	125	2	1	-1	1/-1
ENSG00000151240	ENSG00000160305	0	768	83.073	638	130	1	3	1/3
ENSG00000165516	ENSG00000165525	0	550	99.818	549	1	2	-3	2/-3
ENSG00000174903	ENSG00000138069	2.62e-121	181	96.133	174	7	1	3	1/3
ENSG00000167721	ENSG00000167720	0	243	99.588	242	1	-2	2	-2/2
ENSG00000120438	ENSG00000120437	1.15e-86	136	98.529	134	2	1	-1	1/-1
ENSG00000164588	ENSG00000099822	0	545	85.138	464	81	2	3	2/3
ENSG00000163295	ENSG00000163286	0	508	87.992	447	61	3	2	3/2
ENSG00000163295	ENSG00000163283	0	313	88.818	278	35	-3	-1	-3/-1
ENSG00000147475	ENSG00000107566	4.64e-152	286	84.266	241	45	2	3	2/3
ENSG00000198034	ENSG00000129824	1.37e-171	265	92.83	246	19	1	2	1/2
ENSG00000198034	ENSG00000280969	2.6e-123	247	80.567	199	48	-1	-2	-1/-2
ENSG00000239697	ENSG00000248871	1.03e-87	114	100	114	0	3	2	3/2
ENSG00000180855	ENSG00000196466	0	658	86.018	566	92	-1	-2	-1/-2
ENSG00000180855	ENSG00000196466	0	658	86.018	566	92	-1	-2	-1/-2
ENSG00000173914	ENSG00000173933	0	229	94.76	217	12	3	1	3/1
ENSG00000175634	ENSG00000108443	0	362	80.939	293	69	1	2	1/2
ENSG00000175634	ENSG00000108443	0	362	80.939	293	69	1	2	1/2
ENSG00000170390	ENSG00000133083	0	126	80.952	102	24	2	3	2/3
ENSG00000186832	ENSG00000186847	0	312	88.141	275	37	3	1	3/1
ENSG00000239306	ENSG00000248643	7.93e-97	143	100	143	0	2	3	2/3
ENSG00000120733	ENSG00000115548	0	285	82.456	235	50	3	2	3/2
ENSG00000198077	ENSG00000255974	0	490	94.082	461	29	3	1	3/1
ENSG00000198077	ENSG00000197838	0	489	91.207	446	43	3	1	3/1
ENSG00000129347	ENSG00000130734	5.43e-79	113	100	113	0	-2	2	-2/2
ENSG00000129347	ENSG00000130734	2.66e-74	113	100	113	0	-3	3	-3/3
ENSG00000129347	ENSG00000130734	6.89e-74	113	100	113	0	2	-2	2/-2
ENSG00000129347	ENSG00000130734	1.65e-72	113	100	113	0	1	-1	1/-1
ENSG00000129347	ENSG00000130734	1.3e-65	113	100	113	0	3	-3	3/-3
ENSG00000162337	ENSG00000100068	0	275	83.273	229	46	2	3	2/3
ENSG00000147883	ENSG00000147889	7.69e-64	124	86.29	107	17	3	1	3/1
ENSG00000178586	ENSG00000182083	1.08e-154	307	92.834	285	22	-1	-2	-1/-2
ENSG00000158417	ENSG00000135945	4.4e-180	284	100	284	0	-1	1	-1/1
ENSG00000158417	ENSG00000135945	4.4e-180	284	100	284	0	-1	3	-1/3
ENSG00000126773	ENSG00000100612	0	298	100	298	0	1	-3	1/-3
ENSG00000126773	ENSG00000100612	0	298	100	298	0	3	-2	3/-2
ENSG00000126773	ENSG00000100612	0	298	100	298	0	-1	3	-1/3
ENSG00000126773	ENSG00000100612	5.19e-180	298	100	298	0	-2	1	-2/1
ENSG00000204897	ENSG00000171446	0	269	91.45	246	23	2	3	2/3
ENSG00000204897	ENSG00000173908	0	269	85.13	229	40	2	1	2/1
ENSG00000136404	ENSG00000166503	0	296	99.324	294	2	2	-2	2/-2
ENSG00000213203	ENSG00000281887	2.58e-106	145	99.31	144	1	-1	-3	-1/-3
ENSG00000160072	ENSG00000197785	0	579	89.983	521	58	3	2	3/2
ENSG00000160072	ENSG00000197785	0	579	89.983	521	58	3	2	3/2
ENSG00000181789	ENSG00000158623	0	596	83.725	499	97	3	2	3/2
ENSG00000123064	ENSG00000186710	2.17e-94	125	100	125	0	-1	3	-1/3
ENSG00000160683	ENSG00000186174	0	882	100	882	0	3	-1	3/-1
ENSG00000158023	ENSG00000110801	6.94e-101	145	100	145	0	1	3	1/3
ENSG00000158023	ENSG00000110801	8.14e-99	145	100	145	0	2	1	2/1
ENSG00000158023	ENSG00000110801	1.95e-93	145	100	145	0	-1	-2	-1/-2
ENSG00000164933	ENSG00000164934	2.34e-49	108	99.074	107	1	-2	1	-2/1
ENSG00000180708	ENSG00000173285	2.65e-86	110	86.364	95	15	-3	-1	-3/-1
ENSG00000152093	ENSG00000136698	0	250	99.6	249	1	1	3	1/3
ENSG00000166794	ENSG00000157734	5.17e-92	111	100	111	0	-3	3	-3/3
ENSG00000173542	ENSG00000114978	2.3e-157	217	95.853	208	9	1	3	1/3
ENSG00000151743	ENSG00000139160	0	373	100	373	0	-2	3	-2/3
ENSG00000172476	ENSG00000102128	0	242	98.347	238	4	1	3	1/3
ENSG00000162928	ENSG00000138592	9.76e-111	100	82	82	18	-1	-2	-1/-2
ENSG00000145626	ENSG00000168671	0	389	80.206	312	77	-2	-3	-2/-3
ENSG00000213512	ENSG00000162654	0	482	82.365	397	85	2	3	2/3
ENSG00000172922	ENSG00000172977	1.1e-158	191	97.906	187	4	-1	3	-1/3
ENSG00000172922	ENSG00000172977	1.1e-158	191	97.906	187	4	-1	2	-1/2
ENSG00000156925	ENSG00000152977	7.45e-158	185	89.73	166	19	2	1	2/1
ENSG00000172023	ENSG00000115386	1.41e-101	217	81.106	176	41	-1	-2	-1/-2
ENSG00000151615	ENSG00000152192	8.78e-105	177	85.876	152	25	3	1	3/1
ENSG00000140525	ENSG00000140521	3.92e-81	153	94.118	144	9	-1	3	-1/3
ENSG00000175548	ENSG00000139133	0	131	89.313	117	14	3	2	3/2
ENSG00000102189	ENSG00000187510	0	485	100	485	0	-1	3	-1/3
ENSG00000154342	ENSG00000108379	0	344	85.465	294	50	1	2	1/2
ENSG00000178934	ENSG00000205076	1.69e-103	155	100	155	0	2	1	2/1
ENSG00000176014	ENSG00000258947	0	277	96.029	266	11	1	3	1/3
ENSG00000173757	ENSG00000126561	0	686	95.19	653	33	2	1	2/1
ENSG00000189052	ENSG00000213030	7.57e-173	214	98.598	211	3	3	2	3/2
ENSG00000140632	ENSG00000163735	6.12e-114	107	81.308	87	20	1	3	1/3
ENSG00000173457	ENSG00000182541	7.83e-110	171	91.228	156	15	2	3	2/3
ENSG00000173548	ENSG00000177971	4.63e-155	128	100	128	0	1	-1	1/-1
ENSG00000172487	ENSG00000167822	5.55e-177	281	90.391	254	27	3	2	3/2
ENSG00000170953	ENSG00000197125	8.29e-136	139	82.734	115	24	2	1	2/1
ENSG00000162066	ENSG00000205923	0	457	100	457	0	-1	2	-1/2
ENSG00000153779	ENSG00000176679	1.5e-124	197	92.893	183	14	-2	-1	-2/-1
ENSG00000171469	ENSG00000171466	0	300	86.667	260	40	2	1	2/1
ENSG00000153147	ENSG00000102038	0	750	86.4	648	102	1	2	1/2
ENSG00000179388	ENSG00000122877	1.85e-81	108	88.889	96	12	2	3	2/3
ENSG00000156052	ENSG00000088256	0	315	91.111	287	28	2	3	2/3
ENSG00000213160	ENSG00000144362	4.3e-65	112	100	112	0	1	2	1/2
ENSG00000213160	ENSG00000144362	5.04e-59	112	100	112	0	2	3	2/3
ENSG00000157827	ENSG00000161791	0	130	86.154	112	18	2	1	2/1
ENSG00000151746	ENSG00000185963	0	201	85.572	172	29	2	3	2/3
ENSG00000144712	ENSG00000111530	0	189	81.481	154	35	1	3	1/3
ENSG00000180016	ENSG00000127780	1.8e-162	188	92.021	173	15	-1	-2	-1/-2
ENSG00000173020	ENSG00000100077	0	685	84.088	576	109	3	1	3/1
ENSG00000167880	ENSG00000214860	0	113	92.035	104	9	3	2	3/2
ENSG00000167552	ENSG00000167553	0	454	89.427	406	48	-2	-3	-2/-3
ENSG00000106246	ENSG00000248919	0	458	100	458	0	-1	-3	-1/-3
ENSG00000141551	ENSG00000213923	0	298	96.98	289	9	3	2	3/2
ENSG00000236761	ENSG00000244693	0	545	98.716	538	7	1	3	1/3
ENSG00000236761	ENSG00000225932	0	545	98.532	537	8	1	3	1/3
ENSG00000149657	ENSG00000257103	8.8e-77	103	85.437	88	15	2	1	2/1
ENSG00000149657	ENSG00000257103	1.02e-76	103	85.437	88	15	2	3	2/3
ENSG00000113240	ENSG00000013441	0	342	87.135	298	44	2	3	2/3
ENSG00000267855	ENSG00000167774	2.86e-90	151	100	151	0	-1	-3	-1/-3
ENSG00000167996	ENSG00000167995	3.29e-146	203	99.507	202	1	-2	2	-2/2
ENSG00000126945	ENSG00000169045	0	207	85.99	178	29	-2	-3	-2/-3
ENSG00000126945	ENSG00000169045	0	207	85.99	178	29	-2	-1	-2/-1
ENSG00000100934	ENSG00000101310	0	547	83.912	459	88	3	1	3/1
ENSG00000100934	ENSG00000101310	0	547	83.912	459	88	3	2	3/2
ENSG00000204414	ENSG00000213218	1.52e-111	159	91.824	146	13	3	2	3/2
ENSG00000153976	ENSG00000125430	2.56e-180	273	95.238	260	13	1	2	1/2
ENSG00000153976	ENSG00000125430	2.56e-180	273	95.238	260	13	1	2	1/2
ENSG00000125375	ENSG00000100490	0	260	100	260	0	-3	3	-3/3
ENSG00000125375	ENSG00000100490	0	260	100	260	0	2	-1	2/-1
ENSG00000181761	ENSG00000181767	0	313	92.013	288	25	1	3	1/3
ENSG00000181761	ENSG00000181767	0	313	92.013	288	25	1	2	1/2
ENSG00000140015	ENSG00000143473	0	317	84.858	269	48	3	1	3/1
ENSG00000165496	ENSG00000147403	2.03e-145	223	93.722	209	14	2	3	2/3
ENSG00000165496	ENSG00000147403	2.03e-145	223	93.722	209	14	2	1	2/1
ENSG00000156802	ENSG00000119778	0	335	81.791	274	61	1	3	1/3
ENSG00000154118	ENSG00000149596	2.12e-141	173	80.347	139	34	3	1	3/1
ENSG00000168904	ENSG00000136213	9.21e-98	112	83.929	94	18	-1	2	-1/2
ENSG00000152932	ENSG00000105649	3.65e-118	194	88.66	172	22	2	3	2/3
ENSG00000152932	ENSG00000169213	1.4e-116	209	81.818	171	38	2	1	2/1
ENSG00000196705	ENSG00000160352	0	486	85.597	416	70	-3	-2	-3/-2
ENSG00000139318	ENSG00000164086	2.96e-154	199	80.402	160	39	3	2	3/2
ENSG00000255529	ENSG00000137878	0	353	99.717	352	1	3	2	3/2
ENSG00000170262	ENSG00000142207	3.86e-139	203	100	203	0	3	-2	3/-2
ENSG00000170262	ENSG00000142207	8.54e-129	203	100	203	0	-1	2	-1/2
ENSG00000159961	ENSG00000221882	2.22e-158	204	100	204	0	-3	-2	-3/-2
ENSG00000174125	ENSG00000174130	0	326	90.184	294	32	-3	-1	-3/-1
ENSG00000169918	ENSG00000264522	0	197	80.711	159	38	1	2	1/2
ENSG00000173451	ENSG00000133858	0	320	99.688	319	1	2	-2	2/-2
ENSG00000182196	ENSG00000150967	3.75e-147	204	100	204	0	3	-3	3/-3
ENSG00000154917	ENSG00000175582	2.84e-127	210	90.952	191	19	3	1	3/1
ENSG00000129968	ENSG00000136379	1.27e-140	249	80.723	201	48	3	2	3/2
ENSG00000161509	ENSG00000105464	0	418	83.493	349	69	1	2	1/2
ENSG00000152580	ENSG00000144893	0	1192	100	1192	0	3	-3	3/-3
ENSG00000167195	ENSG00000140478	0	338	99.704	337	1	3	2	3/2
ENSG00000167195	ENSG00000215186	0	180	98.333	177	3	-2	-3	-2/-3
ENSG00000163755	ENSG00000047457	0	411	100	411	0	-1	2	-1/2
ENSG00000166823	ENSG00000188095	2.52e-62	102	85.294	87	15	2	1	2/1
ENSG00000072062	ENSG00000142875	0	345	93.043	321	24	3	1	3/1
ENSG00000126785	ENSG00000119729	4.69e-100	190	80	152	38	1	2	1/2
ENSG00000170296	ENSG00000139112	1e-66	116	87.069	101	15	3	2	3/2
ENSG00000170296	ENSG00000139112	1e-66	116	87.069	101	15	3	2	3/2
ENSG00000145863	ENSG00000109158	0	334	83.533	279	55	2	3	2/3
ENSG00000066084	ENSG00000151240	0	152	88.816	135	17	2	1	2/1
ENSG00000066084	ENSG00000160305	0	149	89.262	133	16	2	1	2/1
ENSG00000156269	ENSG00000102030	1.65e-115	172	91.86	158	14	3	2	3/2
ENSG00000154274	ENSG00000181826	4.32e-82	142	99.296	141	1	-2	1	-2/1
ENSG00000170486	ENSG00000139648	0	364	85.989	313	51	3	2	3/2
ENSG00000170925	ENSG00000268629	1.53e-153	168	82.738	139	29	1	2	1/2
ENSG00000255974	ENSG00000198077	0	535	91.402	489	46	1	3	1/3
ENSG00000255974	ENSG00000197838	0	323	89.783	290	33	-1	-3	-1/-3
ENSG00000171931	ENSG00000241322	0	620	98.71	612	8	3	1	3/1
ENSG00000157911	ENSG00000157916	0	292	100	292	0	2	-1	2/-1
ENSG00000149968	ENSG00000166670	0	217	85.714	186	31	3	2	3/2
ENSG00000170577	ENSG00000126778	2.17e-121	174	95.977	167	7	3	1	3/1
ENSG00000164508	ENSG00000233822	9.95e-57	124	83.065	103	21	-2	3	-2/3
ENSG00000169609	ENSG00000108587	0	175	87.429	153	22	2	3	2/3
ENSG00000169609	ENSG00000144401	0	172	82.558	142	30	2	-2	2/-2
ENSG00000277075	ENSG00000233822	1.9e-68	114	93.86	107	7	1	-1	1/-1
ENSG00000174749	ENSG00000112096	0	519	88.632	460	59	-2	-3	-2/-3
ENSG00000174749	ENSG00000173200	0	329	89.97	296	33	1	3	1/3
ENSG00000173349	ENSG00000136709	0	692	100	692	0	3	-3	3/-3
ENSG00000169629	ENSG00000183054	0	802	99.751	800	2	1	3	1/3
ENSG00000169629	ENSG00000015568	0	946	99.683	943	3	-2	-3	-2/-3
ENSG00000149269	ENSG00000077264	0	301	90.033	271	30	3	2	3/2
ENSG00000146859	ENSG00000122783	2.98e-97	144	100	144	0	-3	3	-3/3
ENSG00000146859	ENSG00000122783	1.35e-95	144	100	144	0	2	-2	2/-2
ENSG00000146859	ENSG00000122783	2.17e-93	144	100	144	0	3	-3	3/-3
ENSG00000146859	ENSG00000122783	7.72e-93	144	100	144	0	-1	1	-1/1
ENSG00000146859	ENSG00000122783	2.98e-97	144	100	144	0	-3	3	-3/3
ENSG00000146859	ENSG00000122783	1.35e-95	144	100	144	0	2	-2	2/-2
ENSG00000146859	ENSG00000122783	2.17e-93	144	100	144	0	3	-3	3/-3
ENSG00000146859	ENSG00000122783	7.72e-93	144	100	144	0	-1	1	-1/1
ENSG00000151694	ENSG00000134330	0	414	100	414	0	-1	2	-1/2
ENSG00000170790	ENSG00000166363	0	338	92.012	311	27	-3	-2	-3/-2
ENSG00000180658	ENSG00000243896	0	585	99.487	582	3	-2	-3	-2/-3
ENSG00000178338	ENSG00000169131	0	439	87.927	386	53	2	1	2/1
ENSG00000163093	ENSG00000169609	0	165	86.061	142	23	-2	-3	-2/-3
ENSG00000163093	ENSG00000144401	0	106	82.075	87	19	-2	2	-2/2
ENSG00000000460	ENSG00000000457	0	314	98.726	310	4	-3	3	-3/3
ENSG00000166411	ENSG00000103740	0	869	100	869	0	1	-1	1/-1
ENSG00000133392	ENSG00000133026	0	896	82.478	739	157	3	2	3/2
ENSG00000170832	ENSG00000129204	0	784	92.73	727	57	-2	-3	-2/-3
ENSG00000170832	ENSG00000129204	0	784	92.73	727	57	-2	-1	-2/-1
ENSG00000155760	ENSG00000180340	0	368	82.88	305	63	2	3	2/3
ENSG00000155760	ENSG00000157240	0	134	85.075	114	20	-2	-1	-2/-1
ENSG00000161082	ENSG00000101489	0	104	82.692	86	18	2	1	2/1
ENSG00000158941	ENSG00000147439	0	356	100	356	0	-1	1	-1/1
ENSG00000184492	ENSG00000170122	0	358	94.413	338	20	3	2	3/2
ENSG00000184492	ENSG00000187559	0	273	95.971	262	11	3	1	3/1
ENSG00000173273	ENSG00000107854	0	615	85.041	523	92	3	2	3/2
ENSG00000186787	ENSG00000147059	0	350	96.857	339	11	2	1	2/1
ENSG00000177504	ENSG00000205642	4.49e-144	161	98.137	158	3	-3	-2	-3/-2
ENSG00000144560	ENSG00000197548	0	407	100	407	0	-3	3	-3/3
ENSG00000136488	ENSG00000213218	1.33e-175	179	98.324	176	3	-3	-1	-3/-1
ENSG00000136488	ENSG00000213218	9.74e-169	179	98.324	176	3	-3	-2	-3/-2
ENSG00000167165	ENSG00000241635	0	245	100	245	0	-2	-1	-2/-1
ENSG00000164898	ENSG00000269955	6.6e-58	100	95	95	5	-1	-2	-1/-2
ENSG00000158639	ENSG00000234068	8.19e-76	136	84.559	115	21	-1	-3	-1/-3
ENSG00000156968	ENSG00000100784	0	102	81.373	83	19	-2	3	-2/3
ENSG00000175711	ENSG00000141556	2.16e-58	102	89.216	91	11	3	-2	3/-2
ENSG00000176020	ENSG00000173540	0	445	100	445	0	3	1	3/1
ENSG00000087116	ENSG00000156140	0	279	86.38	241	38	1	2	1/2
ENSG00000151693	ENSG00000119185	0	736	100	736	0	-1	2	-1/2
ENSG00000154016	ENSG00000154025	0	494	99.595	492	2	-1	3	-1/3
ENSG00000173597	ENSG00000196911	0	274	90.146	247	27	-2	2	-2/2
ENSG00000173597	ENSG00000237515	1.27e-170	249	81.124	202	47	-2	-1	-2/-1
ENSG00000241635	ENSG00000240224	0	756	82.937	627	129	2	1	2/1
ENSG00000148377	ENSG00000107937	0	311	100	311	0	-2	3	-2/3
ENSG00000197919	ENSG00000233816	1.86e-135	212	99.528	211	1	3	1	3/1
ENSG00000272617	ENSG00000258429	2.75e-126	189	98.413	186	3	1	3	1/3
ENSG00000163807	ENSG00000130818	2.13e-55	100	81	81	19	-2	3	-2/3
ENSG00000169230	ENSG00000213347	1.87e-136	148	100	148	0	-2	1	-2/1
ENSG00000169230	ENSG00000213347	7.4e-122	148	100	148	0	3	-1	3/-1
ENSG00000177971	ENSG00000173548	1.11e-155	128	100	128	0	-1	1	-1/1
ENSG00000167191	ENSG00000174628	0	592	100	592	0	3	-2	3/-2
ENSG00000173898	ENSG00000115306	0	592	81.588	483	109	1	3	1/3
ENSG00000166262	ENSG00000156958	4.99e-52	104	94.231	98	6	-1	2	-1/2
ENSG00000172519	ENSG00000186723	0	318	92.767	295	23	-1	-2	-1/-2
ENSG00000175344	ENSG00000166664	0	450	99.778	449	1	1	3	1/3
ENSG00000092871	ENSG00000005156	0	867	100	867	0	-2	1	-2/1
ENSG00000092871	ENSG00000005156	0	867	100	867	0	1	-2	1/-2
ENSG00000169618	ENSG00000169621	0	241	100	241	0	-3	-2	-3/-2
ENSG00000169618	ENSG00000101292	1.74e-152	241	84.232	203	38	-3	-2	-3/-2
ENSG00000136709	ENSG00000173349	0	692	100	692	0	-3	3	-3/3
ENSG00000156096	ENSG00000171234	0	527	83.681	441	86	-3	-1	-3/-1
ENSG00000156096	ENSG00000213759	0	514	82.879	426	88	-3	-2	-3/-2
ENSG00000069493	ENSG00000181163	2.94e-161	122	91.803	112	10	1	2	1/2
ENSG00000173480	ENSG00000198466	0	724	95.58	692	32	-3	-1	-3/-1
ENSG00000188092	ENSG00000117262	0	491	100	491	0	-3	-1	-3/-1
ENSG00000167395	ENSG00000151006	1.44e-89	128	100	128	0	1	-1	1/-1
ENSG00000167395	ENSG00000151006	2.17e-83	128	100	128	0	3	-3	3/-3
ENSG00000155918	ENSG00000131015	1.08e-141	235	88.936	209	26	-3	-1	-3/-1
ENSG00000144445	ENSG00000197713	0	278	100	278	0	-2	2	-2/2
ENSG00000144445	ENSG00000197713	1.77e-171	278	100	278	0	1	-2	1/-2
ENSG00000242220	ENSG00000166984	5.62e-132	169	80.473	136	33	-3	-1	-3/-1
ENSG00000242220	ENSG00000203690	1.4e-113	106	82.075	87	19	-2	-3	-2/-3
ENSG00000153922	ENSG00000173575	0	499	85.972	429	70	2	1	2/1
ENSG00000166670	ENSG00000149968	0	390	80.256	313	77	2	3	2/3
ENSG00000005075	ENSG00000267645	9.25e-58	109	82.569	90	19	2	1	2/1
ENSG00000112210	ENSG00000112208	0	341	100	341	0	3	-2	3/-2
ENSG00000104043	ENSG00000143515	0	189	81.481	154	35	2	1	2/1
ENSG00000168131	ENSG00000124657	7.12e-171	310	81.613	253	57	3	1	3/1
ENSG00000169548	ENSG00000275004	3.52e-125	196	81.122	159	37	1	2	1/2
ENSG00000129250	ENSG00000054523	0	372	81.183	302	70	1	2	1/2
ENSG00000166862	ENSG00000006116	9.66e-130	167	86.228	144	23	2	3	2/3
ENSG00000180901	ENSG00000167977	6.85e-96	162	83.951	136	26	1	3	1/3
ENSG00000152270	ENSG00000172572	0	100	84	84	16	3	2	3/2
ENSG00000258947	ENSG00000188229	0	273	95.971	262	11	1	2	1/2
ENSG00000103512	ENSG00000103226	0	687	99.272	682	5	1	2	1/2
ENSG00000103512	ENSG00000185164	0	712	99.438	708	4	-3	-1	-3/-1
ENSG00000283706	ENSG00000206549	0	270	100	270	0	3	1	3/1
ENSG00000169800	ENSG00000234414	0	415	99.277	412	3	2	3	2/3
ENSG00000169800	ENSG00000242875	0	415	99.518	413	2	2	3	2/3
ENSG00000016391	ENSG00000157388	0	465	100	465	0	-3	1	-3/1
ENSG00000167702	ENSG00000160973	2.34e-166	263	100	263	0	1	-2	1/-2
ENSG00000170608	ENSG00000125798	2.95e-50	102	81.373	83	19	-3	-1	-3/-1
ENSG00000170608	ENSG00000125798	3.96e-50	102	81.373	83	19	-3	-1	-3/-1
ENSG00000248871	ENSG00000161955	0	431	98.144	423	8	-1	-2	-1/-2
ENSG00000176299	ENSG00000274102	0	350	94	329	21	1	3	1/3
ENSG00000106714	ENSG00000154529	0	1216	98.273	1195	21	3	1	3/1
ENSG00000170255	ENSG00000179826	4.87e-149	163	88.344	144	19	1	3	1/3
ENSG00000172345	ENSG00000172349	0	1381	100	1381	0	2	-2	2/-2
ENSG00000145284	ENSG00000151131	8.62e-81	122	86.885	106	16	-1	-3	-1/-3
ENSG00000070756	ENSG00000090621	0	442	83.258	368	74	2	3	2/3
ENSG00000070756	ENSG00000090621	0	442	83.258	368	74	2	1	2/1
ENSG00000171446	ENSG00000204897	0	269	91.45	246	23	3	2	3/2
ENSG00000171446	ENSG00000173908	0	269	85.13	229	40	3	1	3/1
ENSG00000117877	ENSG00000012061	0	227	100	227	0	1	-2	1/-2
ENSG00000149929	ENSG00000169592	7.4e-171	284	99.648	283	1	2	-2	2/-2
ENSG00000171478	ENSG00000171489	5.79e-119	170	100	170	0	1	3	1/3
ENSG00000171478	ENSG00000171489	6.27e-112	170	100	170	0	2	1	2/1
ENSG00000160882	ENSG00000179142	0	407	89.681	365	42	-1	-3	-1/-3
ENSG00000159289	ENSG00000215186	0	338	98.817	334	4	2	3	2/3
ENSG00000185013	ENSG00000250741	0	406	100	406	0	3	2	3/2
ENSG00000179271	ENSG00000179262	5.37e-102	152	100	152	0	1	-3	1/-3
ENSG00000172058	ENSG00000205572	5.94e-136	211	100	211	0	-1	-2	-1/-2
ENSG00000173660	ENSG00000233954	8.84e-93	149	95.973	143	6	-1	-2	-1/-2
ENSG00000153201	ENSG00000153165	0	629	96.82	609	20	-2	-1	-2/-1
ENSG00000153201	ENSG00000196862	0	514	96.304	495	19	1	3	1/3
ENSG00000147488	ENSG00000196132	0	103	81.553	84	19	1	2	1/2
ENSG00000156103	ENSG00000125966	0	176	85.227	150	26	1	2	1/2
ENSG00000146707	ENSG00000188372	2.13e-126	111	98.198	109	2	-1	-3	-1/-3
ENSG00000152977	ENSG00000043355	8.04e-135	208	83.173	173	35	-2	-1	-2/-1
ENSG00000152977	ENSG00000156925	5.18e-136	186	89.785	167	19	1	2	1/2
ENSG00000181718	ENSG00000181698	1.01e-127	188	80.319	151	37	1	2	1/2
ENSG00000181718	ENSG00000181698	1.01e-127	188	80.319	151	37	1	2	1/2
ENSG00000165478	ENSG00000221932	0	478	100	478	0	3	-1	3/-1
ENSG00000140274	ENSG00000140254	1.48e-162	235	100	235	0	2	-1	2/-1
ENSG00000140274	ENSG00000140254	4.16e-155	235	100	235	0	-3	1	-3/1
ENSG00000108242	ENSG00000138109	0	484	81.818	396	88	2	1	2/1
ENSG00000158805	ENSG00000187741	0	173	99.422	172	1	3	-2	3/-2
ENSG00000177839	ENSG00000120324	0	669	92.377	618	51	1	3	1/3
ENSG00000166439	ENSG00000166435	0	727	100	727	0	-3	2	-3/2
ENSG00000181826	ENSG00000154274	2.83e-82	142	99.296	141	1	1	-2	1/-2
ENSG00000243056	ENSG00000254996	9.14e-74	130	100	130	0	1	2	1/2
ENSG00000172367	ENSG00000248712	5.33e-119	170	100	170	0	-2	3	-2/3
ENSG00000172367	ENSG00000248712	1.62e-116	170	100	170	0	3	-2	3/-2
ENSG00000171103	ENSG00000163806	2.43e-96	133	99.248	132	1	2	-1	2/-1
ENSG00000171103	ENSG00000163806	2.43e-96	133	99.248	132	1	2	-1	2/-1
ENSG00000127507	ENSG00000160961	0	451	100	451	0	2	-1	2/-1
ENSG00000057149	ENSG00000206073	0	383	91.906	352	31	2	1	2/1
ENSG00000160201	ENSG00000275895	6.13e-170	208	100	208	0	3	1	3/1
ENSG00000169627	ENSG00000183336	1.39e-105	193	98.964	191	2	-1	-2	-1/-2
ENSG00000159263	ENSG00000112246	0	359	86.072	309	50	2	1	2/1
ENSG00000159263	ENSG00000112246	0	359	86.072	309	50	2	3	2/3
ENSG00000168792	ENSG00000171109	2.94e-49	101	85.149	86	15	1	-3	1/-3
ENSG00000168792	ENSG00000130818	1.23e-50	100	86	86	14	2	-1	2/-1
ENSG00000161217	ENSG00000102230	1.39e-139	203	80.788	164	39	3	1	3/1
ENSG00000159217	ENSG00000136231	0	163	82.209	134	29	2	1	2/1
ENSG00000151725	ENSG00000164306	1.35e-67	114	100	114	0	-3	2	-3/2
ENSG00000168505	ENSG00000164900	1.17e-69	100	90	90	10	3	1	3/1
ENSG00000144583	ENSG00000139266	2.45e-122	185	86.486	160	25	1	3	1/3
ENSG00000166946	ENSG00000166947	0	361	100	361	0	-3	1	-3/1
ENSG00000164900	ENSG00000168505	2.45e-69	108	87.037	94	14	1	3	1/3
ENSG00000156006	ENSG00000171428	5.7e-180	307	80.13	246	61	3	2	3/2
ENSG00000169871	ENSG00000003402	0	201	90.547	182	19	3	-3	3/-3
ENSG00000169871	ENSG00000175387	0	201	89.552	180	21	3	-2	3/-2
ENSG00000171295	ENSG00000197054	0	300	83.333	250	50	-1	-2	-1/-2
ENSG00000171295	ENSG00000171291	0	353	82.153	290	63	-2	-1	-2/-1
ENSG00000164855	ENSG00000198517	4.09e-178	269	100	269	0	-2	2	-2/2
ENSG00000164855	ENSG00000198517	9.82e-149	269	100	269	0	2	-1	2/-1
ENSG00000152684	ENSG00000213949	7.31e-106	158	100	158	0	-2	-3	-2/-3
ENSG00000152684	ENSG00000213949	1.27e-104	158	100	158	0	-3	-1	-3/-1
ENSG00000168906	ENSG00000115486	1.3e-126	185	100	185	0	-3	3	-3/3
ENSG00000168906	ENSG00000115486	2.66e-119	185	100	185	0	2	-3	2/-3
ENSG00000162391	ENSG00000162390	9.8e-180	255	99.608	254	1	-3	1	-3/1
ENSG00000167306	ENSG00000197535	0	119	80.672	96	23	-3	-1	-3/-1
ENSG00000167306	ENSG00000197535	0	119	80.672	96	23	-3	-1	-3/-1
ENSG00000146352	ENSG00000177182	5.87e-176	282	84.043	237	45	1	2	1/2
ENSG00000145912	ENSG00000145916	2.49e-81	107	100	107	0	2	-3	2/-3
ENSG00000163464	ENSG00000180871	1.99e-153	292	84.589	247	45	-2	-3	-2/-3
ENSG00000157654	ENSG00000241978	0	645	100	645	0	3	1	3/1
ENSG00000169032	ENSG00000126934	0	225	92.444	208	17	1	3	1/3
ENSG00000127080	ENSG00000188312	0	446	100	446	0	-2	2	-2/2
ENSG00000127080	ENSG00000188312	0	446	100	446	0	-2	3	-2/3
ENSG00000120669	ENSG00000250709	5.78e-130	201	99.502	200	1	-3	-1	-3/-1
ENSG00000163558	ENSG00000067606	0	229	85.153	195	34	3	2	3/2
ENSG00000157322	ENSG00000157335	0	686	98.688	677	9	2	1	2/1
ENSG00000145029	ENSG00000283189	0	602	100	602	0	-2	-3	-2/-3
ENSG00000151846	ENSG00000070756	0	292	88.356	258	34	-3	-2	-3/-2
ENSG00000151846	ENSG00000090621	0	393	81.425	320	73	2	3	2/3
ENSG00000183542	ENSG00000205810	6.27e-91	110	87.273	96	14	-2	-3	-2/-3
ENSG00000183542	ENSG00000205810	1.01e-80	110	87.273	96	14	-3	-1	-3/-1
ENSG00000151006	ENSG00000167395	4.21e-90	128	100	128	0	-1	1	-1/1
ENSG00000151006	ENSG00000167395	6.35e-84	128	100	128	0	-3	3	-3/3
ENSG00000144228	ENSG00000121067	0	329	85.41	281	48	2	3	2/3
ENSG00000144228	ENSG00000121067	0	329	85.41	281	48	2	3	2/3
ENSG00000166246	ENSG00000103199	2.2e-134	188	100	188	0	3	-2	3/-2
ENSG00000187754	ENSG00000268447	0	350	89.429	313	37	1	2	1/2
ENSG00000187754	ENSG00000165583	0	340	83.529	284	56	1	3	1/3
ENSG00000151665	ENSG00000119729	8.88e-144	219	100	219	0	-1	2	-1/2
ENSG00000145337	ENSG00000163596	0	165	91.515	151	14	2	1	2/1
ENSG00000122194	ENSG00000198670	0	250	85.6	214	36	-1	-2	-1/-2
ENSG00000170390	ENSG00000133083	0	126	80.952	102	24	1	3	1/3
ENSG00000187048	ENSG00000162365	0	479	95.407	457	22	3	2	3/2
ENSG00000151729	ENSG00000169100	1.3e-176	303	87.789	266	37	1	2	1/2
ENSG00000151729	ENSG00000005022	6.34e-176	299	88.963	266	33	1	3	1/3
ENSG00000146731	ENSG00000132141	0	540	85	459	81	1	3	1/3
ENSG00000147251	ENSG00000135905	0	114	81.579	93	21	1	3	1/3
ENSG00000037757	ENSG00000136213	3.35e-102	100	80	80	20	3	-3	3/-3
ENSG00000179564	ENSG00000214706	6.6e-87	127	100	127	0	3	-2	3/-2
ENSG00000179564	ENSG00000214706	4.45e-86	127	100	127	0	-2	3	-2/3
ENSG00000179564	ENSG00000214706	5.2e-84	127	100	127	0	1	-3	1/-3
ENSG00000165434	ENSG00000101966	5.06e-72	101	82.178	83	18	-1	-2	-1/-2
ENSG00000155428	ENSG00000178809	0	389	99.743	388	1	3	2	3/2
ENSG00000146281	ENSG00000166200	7.57e-86	132	82.576	109	23	1	3	1/3
ENSG00000176105	ENSG00000197122	0	456	84.211	384	72	2	1	2/1
ENSG00000163285	ENSG00000113327	0	253	82.213	208	45	1	2	1/2
ENSG00000163285	ENSG00000113327	0	253	82.213	208	45	1	3	1/3
ENSG00000167553	ENSG00000167552	0	463	88.553	410	53	-3	-2	-3/-2
ENSG00000160714	ENSG00000140367	2.56e-169	221	86.878	192	29	3	2	3/2
ENSG00000160714	ENSG00000140367	8.07e-154	221	86.878	192	29	3	2	3/2
ENSG00000179817	ENSG00000170255	3.59e-151	196	81.122	159	37	-3	-2	-3/-2
ENSG00000135968	ENSG00000183054	0	296	89.189	264	32	-3	-1	-3/-1
ENSG00000135968	ENSG00000015568	0	296	89.189	264	32	-3	-2	-3/-2
ENSG00000172780	ENSG00000261796	0	442	100	442	0	3	2	3/2
ENSG00000111196	ENSG00000162385	1.95e-96	148	98.649	146	2	2	1	2/1
ENSG00000128394	ENSG00000243811	0	360	83.889	302	58	1	3	1/3
ENSG00000128394	ENSG00000244509	0	155	81.29	126	29	3	1	3/1
ENSG00000173110	ENSG00000204389	0	293	83.959	246	47	-1	-2	-1/-2
ENSG00000173110	ENSG00000204388	0	637	82.575	526	111	3	1	3/1
ENSG00000165584	ENSG00000268447	0	342	92.398	316	26	-3	-2	-3/-2
ENSG00000163251	ENSG00000177283	0	112	86.607	97	15	3	1	3/1
ENSG00000197888	ENSG00000171234	0	318	80.503	256	62	-2	-1	-2/-1
ENSG00000163888	ENSG00000145194	2.48e-84	124	100	124	0	1	-2	1/-2
ENSG00000165525	ENSG00000165516	0	550	99.818	549	1	-3	2	-3/2
ENSG00000166398	ENSG00000177225	7.12e-48	102	82.353	84	18	2	1	2/1
ENSG00000166398	ENSG00000177225	7.12e-48	102	82.353	84	18	2	1	2/1
ENSG00000258429	ENSG00000272617	6.82e-127	189	98.413	186	3	3	1	3/1
ENSG00000165502	ENSG00000241343	5.16e-62	121	82.645	100	21	-3	-2	-3/-2
ENSG00000161940	ENSG00000113916	4.49e-138	151	86.755	131	20	3	2	3/2
ENSG00000161940	ENSG00000113916	7.81e-138	151	86.755	131	20	3	2	3/2
ENSG00000153253	ENSG00000144285	0	458	84.716	388	70	1	2	1/2
ENSG00000181693	ENSG00000181767	0	345	85.797	296	49	2	3	2/3
ENSG00000179933	ENSG00000100813	1.35e-131	213	100	213	0	-1	2	-1/2
ENSG00000160202	ENSG00000276076	2.38e-98	198	96.97	192	6	-1	-3	-1/-3
ENSG00000198553	ENSG00000204977	3.86e-172	274	100	274	0	1	2	1/2
ENSG00000226288	ENSG00000232268	0	367	91.826	337	30	2	3	2/3
ENSG00000164647	ENSG00000105889	0	312	88.462	276	36	-1	-2	-1/-2
ENSG00000170759	ENSG00000155980	0	267	85.393	228	39	3	2	3/2
ENSG00000172489	ENSG00000181698	1.51e-149	240	87.5	210	30	1	3	1/3
ENSG00000172489	ENSG00000181698	1.51e-149	240	87.5	210	30	1	3	1/3
ENSG00000279486	ENSG00000188124	1.45e-175	275	87.273	240	35	1	2	1/2
ENSG00000168872	ENSG00000157349	0	489	97.751	478	11	2	1	2/1
ENSG00000167283	ENSG00000249222	5.68e-79	130	85.385	111	19	-2	-3	-2/-3
ENSG00000166377	ENSG00000054793	0	570	82.281	469	101	3	2	3/2
ENSG00000244414	ENSG00000080910	0	172	98.256	169	3	-3	-1	-3/-1
ENSG00000244414	ENSG00000000971	1.33e-169	217	94.47	205	12	-1	-2	-1/-2
ENSG00000152767	ENSG00000102572	0	868	99.539	864	4	2	-2	2/-2
ENSG00000152767	ENSG00000102572	0	868	99.539	864	4	2	-1	2/-1
ENSG00000163319	ENSG00000163322	0	394	99.746	393	1	-2	2	-2/2
ENSG00000008226	ENSG00000060971	1.28e-87	143	97.902	140	3	-1	1	-1/1
ENSG00000008226	ENSG00000060971	1.28e-87	143	97.902	140	3	-1	2	-1/2
ENSG00000198353	ENSG00000197757	2.98e-75	101	100	101	0	-3	-1	-3/-1
ENSG00000105568	ENSG00000137713	0	582	86.426	503	79	2	1	2/1
ENSG00000196778	ENSG00000181963	2.47e-172	324	83.951	272	52	-2	-1	-2/-1
ENSG00000173175	ENSG00000174233	0	317	83.281	264	53	1	3	1/3
ENSG00000157895	ENSG00000135100	0	477	100	477	0	-1	3	-1/3
ENSG00000128422	ENSG00000186847	0	320	88.75	284	36	3	1	3/1
ENSG00000148965	ENSG00000255071	1.78e-101	161	99.379	160	1	-2	-3	-2/-3
ENSG00000198670	ENSG00000122194	0	311	80.064	249	62	-3	-2	-3/-2
ENSG00000176200	ENSG00000172742	1.17e-172	310	82.258	255	55	1	3	1/3
ENSG00000176200	ENSG00000172742	1.17e-172	310	82.258	255	55	1	3	1/3
ENSG00000147439	ENSG00000158941	0	360	100	360	0	-3	3	-3/3
ENSG00000147439	ENSG00000158941	0	360	100	360	0	2	-2	2/-2
ENSG00000251201	ENSG00000243414	0	849	100	849	0	2	3	2/3
ENSG00000163735	ENSG00000140632	4.35e-99	102	86.275	88	14	2	3	2/3
ENSG00000160959	ENSG00000254402	0	164	100	164	0	1	-1	1/-1
ENSG00000137857	ENSG00000140279	0	321	81.308	261	60	-1	-2	-1/-2
ENSG00000244165	ENSG00000243207	0	201	100	201	0	1	3	1/3
ENSG00000175305	ENSG00000164941	0	347	100	347	0	2	-1	2/-1
ENSG00000165646	ENSG00000165650	0	718	100	718	0	2	-2	2/-2
ENSG00000204478	ENSG00000232423	0	257	81.712	210	47	-3	-1	-3/-1
ENSG00000166351	ENSG00000278522	0	586	95.563	560	26	2	1	2/1
ENSG00000166351	ENSG00000183206	0	536	96.455	517	19	2	1	2/1
ENSG00000165985	ENSG00000131094	7.5e-91	141	86.525	122	19	2	3	2/3
ENSG00000165985	ENSG00000144119	1.58e-86	132	88.636	117	15	2	3	2/3
ENSG00000168928	ENSG00000168925	5.3e-158	154	96.104	148	6	-1	-3	-1/-3
ENSG00000170276	ENSG00000254445	1.04e-130	167	100	167	0	2	3	2/3
ENSG00000162804	ENSG00000122085	1.2e-146	146	100	146	0	-2	3	-2/3
ENSG00000162804	ENSG00000122085	1.27e-137	146	100	146	0	3	-3	3/-3
ENSG00000162804	ENSG00000122085	8.18e-121	146	100	146	0	2	-2	2/-2
ENSG00000162804	ENSG00000122085	1.2e-146	146	100	146	0	-2	3	-2/3
ENSG00000162804	ENSG00000122085	1.28e-137	146	100	146	0	3	-2	3/-2
ENSG00000162804	ENSG00000122085	8.2e-121	146	100	146	0	2	-1	2/-1
ENSG00000144199	ENSG00000115042	0	321	98.131	315	6	3	1	3/1
ENSG00000144677	ENSG00000144579	2.68e-108	186	80.645	150	36	3	1	3/1
ENSG00000184227	ENSG00000119673	0	475	96	456	19	-2	-3	-2/-3
ENSG00000157227	ENSG00000125966	0	112	81.25	91	21	1	2	1/2
ENSG00000143365	ENSG00000069667	5.05e-143	113	83.186	94	19	1	3	1/3
ENSG00000073584	ENSG00000264058	7.42e-157	199	100	199	0	2	1	2/1
ENSG00000186897	ENSG00000165985	3.59e-87	133	82.707	110	23	1	2	1/2
ENSG00000186897	ENSG00000131094	1.1e-81	134	88.06	118	16	1	3	1/3
ENSG00000122483	ENSG00000117500	2.71e-60	110	99.091	109	1	-3	2	-3/2
ENSG00000150991	ENSG00000170315	4.41e-150	240	96.25	231	9	1	3	1/3
ENSG00000188779	ENSG00000215474	1.01e-141	203	89.163	181	22	1	2	1/2
ENSG00000231192	ENSG00000233412	0	314	94.586	297	17	1	2	1/2
ENSG00000187634	ENSG00000188976	4.91e-72	124	100	124	0	2	-1	2/-1
ENSG00000185567	ENSG00000166428	3.68e-107	158	100	158	0	-1	3	-1/3
ENSG00000092054	ENSG00000133020	0	922	80.369	741	181	2	3	2/3
ENSG00000229859	ENSG00000256713	0	506	99.012	501	5	-2	-1	-2/-1
ENSG00000129965	ENSG00000167244	6.51e-166	244	97.541	238	6	1	2	1/2
ENSG00000172725	ENSG00000110880	0	417	80.096	334	83	1	2	1/2
ENSG00000185009	ENSG00000035403	0	369	100	369	0	-3	1	-3/1
ENSG00000185009	ENSG00000035403	0	369	100	369	0	1	-3	1/-3
ENSG00000185009	ENSG00000035403	0	369	100	369	0	2	-1	2/-1
ENSG00000136238	ENSG00000169750	1.36e-109	103	90.291	93	10	3	1	3/1
ENSG00000182315	ENSG00000237247	1.92e-177	257	98.444	253	4	-3	-1	-3/-1
ENSG00000182315	ENSG00000237247	1.29e-160	257	98.444	253	4	3	2	3/2
ENSG00000187942	ENSG00000142798	0	204	100	204	0	3	-3	3/-3
ENSG00000189013	ENSG00000125498	1.42e-159	105	81.905	86	19	1	3	1/3
ENSG00000177613	ENSG00000101811	0	208	87.5	182	26	1	2	1/2
ENSG00000177613	ENSG00000101811	0	208	87.5	182	26	1	2	1/2
ENSG00000141556	ENSG00000175711	3.18e-45	106	84.906	90	16	-3	1	-3/1
ENSG00000075891	ENSG00000196092	3.23e-88	131	81.679	107	24	-2	-3	-2/-3
ENSG00000183496	ENSG00000176624	1.51e-129	192	87.5	168	24	2	1	2/1
ENSG00000183496	ENSG00000181588	3.51e-121	193	85.492	165	28	2	1	2/1
ENSG00000187010	ENSG00000188672	0	276	91.667	253	23	-1	-3	-1/-3
ENSG00000140839	ENSG00000157322	0	444	98.649	438	6	3	2	3/2
ENSG00000178035	ENSG00000106348	0	516	83.915	433	83	2	1	2/1
ENSG00000178035	ENSG00000106348	0	516	83.915	433	83	2	1	2/1
ENSG00000165246	ENSG00000146938	0	847	97.166	823	24	1	2	1/2
ENSG00000075624	ENSG00000184009	0	388	96.649	375	13	1	2	1/2
ENSG00000137075	ENSG00000146083	2.01e-136	118	84.746	100	18	3	1	3/1
ENSG00000228049	ENSG00000267645	1.02e-71	116	100	116	0	-1	-2	-1/-2
ENSG00000162654	ENSG00000213512	0	482	82.365	397	85	3	2	3/2
ENSG00000117036	ENSG00000253831	5.38e-72	125	85.6	107	18	2	1	2/1
ENSG00000189132	ENSG00000185448	0	242	80.579	195	47	-3	-1	-3/-1
ENSG00000189132	ENSG00000198173	0	175	81.143	142	33	2	1	2/1
ENSG00000182287	ENSG00000106367	1.65e-88	154	87.662	135	19	2	3	2/3
ENSG00000178860	ENSG00000118526	1.18e-46	104	84.615	88	16	3	1	3/1
ENSG00000180815	ENSG00000197442	0	172	81.977	141	31	1	2	1/2
ENSG00000114374	ENSG00000124486	0	473	88.795	420	53	-3	-1	-3/-1
ENSG00000196981	ENSG00000196363	0	301	89.369	269	32	2	1	2/1
ENSG00000215790	ENSG00000189339	0	282	99.291	280	2	-1	-3	-1/-3
ENSG00000128591	ENSG00000136068	0	251	86.853	218	33	3	1	3/1
ENSG00000105379	ENSG00000173200	3.13e-150	284	81.69	232	52	-2	-3	-2/-3
ENSG00000105379	ENSG00000174749	1.22e-174	197	92.386	182	15	-1	-2	-1/-2
ENSG00000126337	ENSG00000197079	0	336	81.845	275	61	1	2	1/2
ENSG00000157734	ENSG00000166794	8.98e-115	111	100	111	0	-1	3	-1/3
ENSG00000157734	ENSG00000166794	9.44e-94	111	100	111	0	3	-3	3/-3
ENSG00000188313	ENSG00000163746	3.11e-118	112	84.821	95	17	1	3	1/3
ENSG00000213218	ENSG00000136487	0	293	83.618	245	48	-2	-3	-2/-3
ENSG00000241119	ENSG00000242366	0	778	96.53	751	27	2	1	2/1
ENSG00000241119	ENSG00000244122	0	777	95.495	742	35	2	1	2/1
ENSG00000243772	ENSG00000240403	0	414	82.85	343	71	3	2	3/2
ENSG00000243772	ENSG00000167633	0	377	86.472	326	51	3	2	3/2
ENSG00000161791	ENSG00000157827	0	391	82.353	322	69	1	2	1/2
ENSG00000171314	ENSG00000226784	2.7e-157	255	95.686	244	11	2	1	2/1
ENSG00000183196	ENSG00000135702	0	231	86.147	199	32	-3	-1	-3/-1
ENSG00000182810	ENSG00000167264	1.56e-75	119	100	119	0	2	-1	2/-1
ENSG00000183476	ENSG00000136425	5.76e-65	101	100	101	0	2	-1	2/-1
ENSG00000183476	ENSG00000136425	1.09e-64	101	100	101	0	3	-2	3/-2
ENSG00000183476	ENSG00000136425	1.9e-63	101	100	101	0	-1	2	-1/2
ENSG00000183476	ENSG00000136425	4.54e-62	101	100	101	0	-2	3	-2/3
ENSG00000108242	ENSG00000165841	0	231	81.818	189	42	1	2	1/2
ENSG00000181625	ENSG00000132207	0	244	100	244	0	1	2	1/2
ENSG00000183569	ENSG00000189306	3.31e-91	132	90.152	119	13	1	-3	1/-3
ENSG00000179412	ENSG00000277058	0	223	99.552	222	1	-3	-2	-3/-2
ENSG00000179412	ENSG00000275774	2.27e-167	223	93.722	209	14	-3	-2	-3/-2
ENSG00000183709	ENSG00000197110	6.43e-117	183	95.082	174	9	2	1	2/1
ENSG00000166435	ENSG00000166439	0	727	100	727	0	2	-3	2/-3
ENSG00000183426	ENSG00000224712	0	351	99.43	349	2	-2	-1	-2/-1
ENSG00000183426	ENSG00000254852	0	351	99.145	348	3	-2	-1	-2/-1
ENSG00000187372	ENSG00000120322	0	325	96.308	313	12	3	1	3/1
ENSG00000187372	ENSG00000113205	0	298	90.94	271	27	2	1	2/1
ENSG00000219073	ENSG00000142789	4.03e-166	261	90.421	236	25	-3	-2	-3/-2
ENSG00000070808	ENSG00000058404	0	476	85.714	408	68	1	2	1/2
ENSG00000143811	ENSG00000183010	8.52e-159	203	86.7	176	27	3	1	3/1
ENSG00000239839	ENSG00000240247	1.09e-83	121	98.347	119	2	1	3	1/3
ENSG00000239839	ENSG00000206047	2.23e-91	118	99.153	117	1	-2	-1	-2/-1
ENSG00000108515	ENSG00000111674	0	436	83.257	363	73	1	3	1/3
ENSG00000197933	ENSG00000198342	0	505	80.792	408	97	2	1	2/1
ENSG00000240654	ENSG00000205863	0	226	95.133	215	11	2	3	2/3
ENSG00000179520	ENSG00000091664	0	255	80.784	206	49	2	3	2/3
ENSG00000162105	ENSG00000161681	5.07e-118	105	86.667	91	14	1	2	1/2
ENSG00000137267	ENSG00000137285	0	225	100	225	0	-1	-3	-1/-3
ENSG00000184814	ENSG00000233701	2.8e-119	102	84.314	86	16	2	3	2/3
ENSG00000184814	ENSG00000206260	2.19e-121	141	88.652	125	16	-3	-1	-3/-1
ENSG00000142794	ENSG00000162825	0	393	85.751	337	56	-3	-1	-3/-1
ENSG00000186509	ENSG00000186513	3.06e-93	100	80	80	20	-2	-1	-2/-1
ENSG00000128250	ENSG00000128253	0	407	91.646	373	34	1	3	1/3
ENSG00000128250	ENSG00000128276	0	366	89.617	328	38	2	1	2/1
ENSG00000172375	ENSG00000172269	6.67e-89	122	99.18	121	1	3	-3	3/-3
ENSG00000196911	ENSG00000025800	0	308	92.532	285	23	2	1	2/1
ENSG00000163806	ENSG00000171103	4.27e-99	132	100	132	0	1	-2	1/-2
ENSG00000163806	ENSG00000171103	1.59e-95	132	100	132	0	-3	1	-3/1
ENSG00000135111	ENSG00000121068	6.14e-168	239	87.448	209	30	2	3	2/3
ENSG00000115306	ENSG00000173898	0	428	87.383	374	54	2	3	2/3
ENSG00000167100	ENSG00000005882	0	644	100	644	0	3	-1	3/-1
ENSG00000197226	ENSG00000109436	0	129	82.946	107	22	3	1	3/1
ENSG00000183798	ENSG00000132793	2.09e-88	145	100	145	0	-1	2	-1/2
ENSG00000183798	ENSG00000132793	2.26e-85	145	100	145	0	2	-1	2/-1
ENSG00000165246	ENSG00000146938	0	847	97.166	823	24	1	2	1/2
ENSG00000213934	ENSG00000196565	3.81e-125	196	97.959	192	4	3	1	3/1
ENSG00000092820	ENSG00000137710	0	331	85.498	283	48	3	2	3/2
ENSG00000177182	ENSG00000198363	0	363	100	363	0	3	-1	3/-1
ENSG00000204414	ENSG00000136488	8.58e-113	194	94.845	184	10	3	1	3/1
ENSG00000185775	ENSG00000204849	0	459	98.039	450	9	-2	-1	-2/-1
ENSG00000185775	ENSG00000275969	0	459	97.168	446	13	-2	-1	-2/-1
ENSG00000183840	ENSG00000150551	0	319	100	319	0	-1	2	-1/2
ENSG00000105438	ENSG00000136240	1.53e-108	184	84.239	155	29	1	3	1/3
ENSG00000259384	ENSG00000136487	3.49e-156	266	93.233	248	18	2	3	2/3
ENSG00000140526	ENSG00000101558	2.03e-162	121	86.777	105	16	-1	1	-1/1
ENSG00000181963	ENSG00000196778	1.17e-170	321	90.654	291	30	1	2	1/2
ENSG00000181963	ENSG00000196778	1.17e-170	321	90.654	291	30	1	2	1/2
ENSG00000175029	ENSG00000019995	0	622	100	622	0	2	-2	2/-2
ENSG00000175029	ENSG00000019995	0	622	100	622	0	-3	1	-3/1
ENSG00000175029	ENSG00000019995	0	622	100	622	0	1	-1	1/-1
ENSG00000214929	ENSG00000186788	0	820	91.951	754	66	-1	-3	-1/-3
ENSG00000214929	ENSG00000189357	0	820	91.951	754	66	-1	-2	-1/-2
ENSG00000183389	ENSG00000188691	5.14e-150	238	81.092	193	45	-1	-2	-1/-2
ENSG00000181467	ENSG00000125249	7.56e-98	184	90.761	167	17	2	1	2/1
ENSG00000163795	ENSG00000115234	7.7e-68	101	100	101	0	1	-1	1/-1
ENSG00000163795	ENSG00000115234	3.21e-65	101	100	101	0	-1	1	-1/1
ENSG00000184260	ENSG00000272196	2.95e-62	102	100	102	0	1	3	1/3
ENSG00000184260	ENSG00000203812	2.95e-62	102	100	102	0	1	3	1/3
ENSG00000186119	ENSG00000205029	3.26e-148	304	81.25	247	57	3	1	3/1
ENSG00000205426	ENSG00000170442	0	455	96.484	439	16	1	2	1/2
ENSG00000184408	ENSG00000171385	0	236	81.356	192	44	-3	-2	-3/-2
ENSG00000232382	ENSG00000231861	0	319	89.969	287	32	-2	-3	-2/-3
ENSG00000188735	ENSG00000139725	0	295	99.322	293	2	2	-2	2/-2
ENSG00000104177	ENSG00000188467	0	222	97.297	216	6	1	-2	1/-2
ENSG00000198517	ENSG00000164855	2.15e-178	269	100	269	0	2	-2	2/-2
ENSG00000198517	ENSG00000164855	5.17e-149	269	100	269	0	-1	2	-1/2
ENSG00000284609	ENSG00000284680	0	314	96.815	304	10	-1	-3	-1/-3
ENSG00000176422	ENSG00000135423	0	234	100	234	0	-1	1	-1/1
ENSG00000176422	ENSG00000135423	0	234	100	234	0	3	-1	3/-1
ENSG00000176422	ENSG00000135423	0	234	100	234	0	-2	2	-2/2
ENSG00000176422	ENSG00000135423	0	234	100	234	0	-1	1	-1/1
ENSG00000176422	ENSG00000135423	0	234	100	234	0	3	-1	3/-1
ENSG00000176422	ENSG00000135423	0	234	100	234	0	-2	2	-2/2
ENSG00000117013	ENSG00000185760	0	164	90.244	148	16	2	1	2/1
ENSG00000117013	ENSG00000185760	0	164	90.244	148	16	2	3	2/3
ENSG00000188076	ENSG00000268320	2.32e-81	143	97.203	139	4	-1	-3	-1/-3
ENSG00000189253	ENSG00000204450	0	556	98.561	548	8	1	3	1/3
ENSG00000189253	ENSG00000214891	0	314	88.854	279	35	-2	-1	-2/-1
ENSG00000178184	ENSG00000102981	1.38e-95	133	83.459	111	22	1	3	1/3
ENSG00000114030	ENSG00000196911	0	458	84.279	386	72	1	2	1/2
ENSG00000205420	ENSG00000185479	0	226	91.15	206	20	-1	-3	-1/-3
ENSG00000119616	ENSG00000177238	9.37e-147	112	80.357	90	22	-1	3	-1/3
ENSG00000183791	ENSG00000274744	0	497	99.396	494	3	1	2	1/2
ENSG00000183791	ENSG00000206181	0	258	80.62	208	50	3	1	3/1
ENSG00000100027	ENSG00000100023	0	569	100	569	0	-2	2	-2/2
ENSG00000136925	ENSG00000136842	0	555	100	555	0	3	-1	3/-1
ENSG00000164068	ENSG00000173540	4.59e-120	119	97.479	116	3	3	-2	3/-2
ENSG00000164068	ENSG00000173540	3.14e-119	119	97.479	116	3	3	-1	3/-1
ENSG00000072422	ENSG00000008853	0	142	92.254	131	11	3	2	3/2
ENSG00000184110	ENSG00000205609	0	678	100	678	0	1	3	1/3
ENSG00000186174	ENSG00000160683	0	882	100	882	0	-1	3	-1/3
ENSG00000116783	ENSG00000259030	0	717	99.861	716	1	1	3	1/3
ENSG00000156976	ENSG00000161960	0	331	89.124	295	36	2	3	2/3
ENSG00000162390	ENSG00000162391	1.55e-179	255	99.608	254	1	1	-3	1/-3
ENSG00000185448	ENSG00000189132	0	156	83.333	130	26	-2	-1	-2/-1
ENSG00000185448	ENSG00000198173	0	174	82.759	144	30	3	2	3/2
ENSG00000183281	ENSG00000125551	0	388	99.742	387	1	1	2	1/2
ENSG00000183281	ENSG00000122194	0	179	88.827	159	20	-3	-2	-3/-2
ENSG00000183305	ENSG00000268606	0	463	100	463	0	-3	-1	-3/-1
ENSG00000184394	ENSG00000176294	7.19e-159	306	84.641	259	47	1	2	1/2
ENSG00000183960	ENSG00000089558	0	224	81.696	183	41	3	2	3/2
ENSG00000186710	ENSG00000123064	8.45e-94	130	100	130	0	3	-1	3/-1
ENSG00000197616	ENSG00000006788	0	631	81.458	514	117	1	3	1/3
ENSG00000080824	ENSG00000096384	0	256	88.281	226	30	1	3	1/3
ENSG00000161955	ENSG00000248871	0	431	98.144	423	8	-2	-1	-2/-1
ENSG00000187097	ENSG00000119723	3.52e-153	235	99.574	234	1	-2	2	-2/2
ENSG00000241595	ENSG00000187272	1.53e-75	151	83.444	126	25	-2	-1	-2/-1
ENSG00000241595	ENSG00000239886	6.5e-79	151	83.444	126	25	-2	-1	-2/-1
ENSG00000205409	ENSG00000183269	3.17e-176	320	84.375	270	50	-3	-2	-3/-2
ENSG00000099290	ENSG00000172661	0	958	98.225	941	17	1	3	1/3
ENSG00000185262	ENSG00000153443	1.02e-47	103	83.495	86	17	2	1	2/1
ENSG00000256229	ENSG00000237440	0	162	80.247	130	32	3	2	3/2
ENSG00000229292	ENSG00000223638	0	302	99.007	299	3	3	1	3/1
ENSG00000127955	ENSG00000065135	0	362	92.541	335	27	2	3	2/3
ENSG00000067048	ENSG00000215301	0	493	95.132	469	24	2	3	2/3
ENSG00000049618	ENSG00000117713	0	110	83.636	92	18	2	1	2/1
ENSG00000213096	ENSG00000167232	6.6e-61	112	85.714	96	16	1	2	1/2
ENSG00000184911	ENSG00000269502	0	340	98.824	336	4	-2	-3	-2/-3
ENSG00000127249	ENSG00000187527	0	108	80.556	87	21	3	2	3/2
ENSG00000114331	ENSG00000131584	1.5e-81	122	81.148	99	23	1	3	1/3
ENSG00000204880	ENSG00000212721	4.56e-170	123	88.618	109	14	-2	-3	-2/-3
ENSG00000204880	ENSG00000212722	3.73e-128	110	80	88	22	-2	-1	-2/-1
ENSG00000267368	ENSG00000267645	0	198	100	198	0	1	2	1/2
ENSG00000267368	ENSG00000168255	0	165	99.394	164	1	-3	-1	-3/-1
ENSG00000188672	ENSG00000187010	0	341	92.962	317	24	2	1	2/1
ENSG00000185475	ENSG00000168569	1.41e-85	145	100	145	0	1	-1	1/-1
ENSG00000169967	ENSG00000198909	0	278	85.612	238	40	2	3	2/3
ENSG00000215252	ENSG00000232653	0	274	85.036	233	41	3	1	3/1
ENSG00000215252	ENSG00000175265	0	258	100	258	0	-1	-3	-1/-3
ENSG00000182255	ENSG00000177272	6.96e-172	133	91.729	122	11	2	3	2/3
ENSG00000182255	ENSG00000177301	1.59e-170	133	90.226	120	13	2	3	2/3
ENSG00000188229	ENSG00000261456	0	296	88.514	262	34	-3	-1	-3/-1
ENSG00000188229	ENSG00000137285	0	274	98.905	271	3	2	1	2/1
ENSG00000132819	ENSG00000112183	2.97e-70	127	85.039	108	19	2	3	2/3
ENSG00000140505	ENSG00000140465	0	127	81.89	104	23	1	2	1/2
ENSG00000140505	ENSG00000140465	0	127	81.89	104	23	1	3	1/3
ENSG00000038382	ENSG00000160145	0	364	85.165	310	54	1	2	1/2
ENSG00000038382	ENSG00000160145	0	364	85.165	310	54	1	2	1/2
ENSG00000100077	ENSG00000173020	0	687	83.988	577	110	1	3	1/3
ENSG00000123143	ENSG00000065243	0	331	80.363	266	65	2	3	2/3
ENSG00000182782	ENSG00000255398	0	379	95.515	362	17	1	3	1/3
ENSG00000169131	ENSG00000178338	0	433	81.062	351	82	2	3	2/3
ENSG00000175745	ENSG00000185551	0	339	96.165	326	13	2	1	2/1
ENSG00000065883	ENSG00000167258	0	364	87.912	320	44	1	3	1/3
ENSG00000184185	ENSG00000260458	0	500	97.2	486	14	-3	-1	-3/-1
ENSG00000187082	ENSG00000186579	3.44e-60	100	100	100	0	3	2	3/2
ENSG00000187082	ENSG00000186579	6e-51	100	100	100	0	1	3	1/3
ENSG00000054793	ENSG00000166377	0	570	82.281	469	101	2	3	2/3
ENSG00000100319	ENSG00000100314	1.42e-83	139	97.122	135	4	1	-1	1/-1
ENSG00000182108	ENSG00000179583	5.02e-143	228	98.684	225	3	-1	3	-1/3
ENSG00000124593	ENSG00000278224	0	279	100	279	0	3	1	3/1
ENSG00000165650	ENSG00000165646	0	718	100	718	0	-2	2	-2/2
ENSG00000124208	ENSG00000244687	0	505	100	505	0	3	2	3/2
ENSG00000124208	ENSG00000244687	0	505	100	505	0	3	2	3/2
ENSG00000124208	ENSG00000244687	0	505	100	505	0	3	2	3/2
ENSG00000186399	ENSG00000206127	0	221	99.095	219	2	2	1	2/1
ENSG00000186399	ENSG00000232653	0	221	98.643	218	3	2	1	2/1
ENSG00000113296	ENSG00000105664	0	277	87.004	241	36	2	1	2/1
ENSG00000186230	ENSG00000186272	0	118	84.746	100	18	-2	-3	-2/-3
ENSG00000188976	ENSG00000187634	5.4e-72	124	100	124	0	-1	2	-1/2
ENSG00000188542	ENSG00000144504	5.45e-64	117	99.145	116	1	2	-1	2/-1
ENSG00000197021	ENSG00000197620	0	355	97.183	345	10	-1	-2	-1/-2
ENSG00000197021	ENSG00000197620	0	355	97.183	345	10	-2	-3	-2/-3
ENSG00000172236	ENSG00000095917	0	294	85.374	251	43	1	2	1/2
ENSG00000132356	ENSG00000162409	0	243	82.716	201	42	3	1	3/1
ENSG00000186510	ENSG00000184908	0	687	91.266	627	60	2	1	2/1
ENSG00000213533	ENSG00000248592	0	264	100	264	0	2	1	2/1
ENSG00000186723	ENSG00000172519	0	325	91.077	296	29	-2	-1	-2/-1
ENSG00000153250	ENSG00000144642	1.17e-162	194	87.113	169	25	3	1	3/1
ENSG00000135226	ENSG00000213759	0	572	93.881	537	35	3	1	3/1
ENSG00000135226	ENSG00000109181	0	545	87.89	479	66	3	1	3/1
ENSG00000100023	ENSG00000100027	0	569	100	569	0	2	-2	2/-2
ENSG00000150551	ENSG00000183840	1.96e-113	165	100	165	0	-2	3	-2/3
ENSG00000116721	ENSG00000204481	0	486	96.091	467	19	-3	-1	-3/-1
ENSG00000116721	ENSG00000120952	0	547	94.333	516	31	2	1	2/1
ENSG00000170482	ENSG00000089057	0	100	81	81	19	3	1	3/1
ENSG00000186562	ENSG00000186599	4.36e-74	110	100	110	0	1	2	1/2
ENSG00000076555	ENSG00000278540	0	266	87.594	233	33	3	1	3/1
ENSG00000183032	ENSG00000198807	2.08e-80	142	100	142	0	-1	2	-1/2
ENSG00000188629	ENSG00000270011	0	514	100	514	0	-1	-2	-1/-2
ENSG00000116604	ENSG00000068305	5.28e-128	103	91.262	94	9	2	3	2/3
ENSG00000241476	ENSG00000268447	0	357	100	357	0	-3	-2	-3/-2
ENSG00000131183	ENSG00000157765	3.85e-152	139	80.576	112	27	2	1	2/1
ENSG00000158623	ENSG00000181789	0	585	83.761	490	95	2	3	2/3
ENSG00000186329	ENSG00000162924	0	238	82.773	197	41	3	2	3/2
ENSG00000186329	ENSG00000174749	0	231	80.519	186	45	2	-2	2/-2
ENSG00000138756	ENSG00000163291	0	415	98.795	410	5	3	-1	3/-1
ENSG00000146755	ENSG00000178809	0	316	93.354	295	21	1	3	1/3
ENSG00000169953	ENSG00000172468	5.99e-135	205	98.537	202	3	-2	-1	-2/-1
ENSG00000243955	ENSG00000182793	4e-153	250	84	210	40	-3	-2	-3/-2
ENSG00000159899	ENSG00000169418	0	368	80.435	296	72	1	2	1/2
ENSG00000065029	ENSG00000166478	0	217	82.949	180	37	3	1	3/1
ENSG00000123416	ENSG00000167552	0	447	91.499	409	38	-3	-1	-3/-1
ENSG00000132746	ENSG00000006534	0	327	82.875	271	56	2	1	2/1
ENSG00000186298	ENSG00000172531	0	304	96.382	293	11	2	3	2/3
ENSG00000183864	ENSG00000141232	1.45e-68	121	80.165	97	24	3	1	3/1
ENSG00000186714	ENSG00000149100	1.8e-146	251	98.805	248	3	-2	1	-2/1
ENSG00000099977	ENSG00000099974	1.61e-61	104	96.154	100	4	-2	-3	-2/-3
ENSG00000060971	ENSG00000008226	3.34e-88	143	97.902	140	3	1	-1	1/-1
ENSG00000134183	ENSG00000114349	0	344	82.558	284	60	2	1	2/1
ENSG00000187559	ENSG00000273514	0	476	99.16	472	4	3	1	3/1
ENSG00000187559	ENSG00000184492	0	272	95.956	261	11	3	2	3/2
ENSG00000102743	ENSG00000120329	0	315	86.667	273	42	3	1	3/1
ENSG00000119720	ENSG00000100764	0	567	99.471	564	3	-3	3	-3/3
ENSG00000124486	ENSG00000114374	0	332	89.458	297	35	-1	-3	-1/-3
ENSG00000163798	ENSG00000119760	1.49e-79	123	100	123	0	2	-2	2/-2
ENSG00000163798	ENSG00000119760	6.74e-78	123	100	123	0	-2	2	-2/2
ENSG00000163798	ENSG00000119760	3.86e-75	123	100	123	0	-1	1	-1/1
ENSG00000186579	ENSG00000187082	3.21e-60	100	100	100	0	2	3	2/3
ENSG00000186579	ENSG00000187082	5.6e-51	100	100	100	0	3	1	3/1
ENSG00000184270	ENSG00000233822	2.99e-62	109	94.495	103	6	1	-1	1/-1
ENSG00000223443	ENSG00000226430	0	636	92.296	587	49	3	1	3/1
ENSG00000223443	ENSG00000236125	0	531	96.234	511	20	3	1	3/1
ENSG00000188021	ENSG00000135018	0	153	90.85	139	14	2	3	2/3
ENSG00000188021	ENSG00000135018	0	153	90.85	139	14	2	1	2/1
ENSG00000197172	ENSG00000221867	0	466	96.996	452	14	3	2	3/2
ENSG00000197054	ENSG00000171295	0	289	85.467	247	42	-2	-1	-2/-1
ENSG00000197054	ENSG00000196757	0	191	86.387	165	26	-3	-1	-3/-1
ENSG00000197226	ENSG00000109436	0	129	82.946	107	22	3	1	3/1
ENSG00000164749	ENSG00000101076	0	204	81.373	166	38	1	2	1/2
ENSG00000187257	ENSG00000081019	0	363	82.369	299	64	1	2	1/2
ENSG00000179361	ENSG00000116017	8.92e-97	135	84.444	114	21	1	3	1/3
ENSG00000108175	ENSG00000122515	1.44e-174	156	85.256	133	23	-1	-2	-1/-2
ENSG00000188316	ENSG00000187164	0	237	100	237	0	-1	1	-1/1
ENSG00000155506	ENSG00000138709	0	192	82.812	159	33	1	2	1/2
ENSG00000197454	ENSG00000203663	0	363	85.124	309	54	-2	-1	-2/-1
ENSG00000197454	ENSG00000203663	0	363	85.124	309	54	-2	-1	-2/-1
ENSG00000198754	ENSG00000083720	0	218	81.193	177	41	1	3	1/3
ENSG00000120088	ENSG00000263715	0	582	100	582	0	-3	-2	-3/-2
ENSG00000083312	ENSG00000105576	0	481	90.229	434	47	1	2	1/2
ENSG00000119723	ENSG00000187097	1.22e-153	235	99.574	234	1	2	-2	2/-2
ENSG00000119723	ENSG00000187097	1.13e-144	235	99.574	234	1	-3	1	-3/1
ENSG00000186666	ENSG00000136213	1.41e-57	103	91.262	94	9	1	2	1/2
ENSG00000186666	ENSG00000173559	5.43e-54	100	93	93	7	3	2	3/2
ENSG00000178177	ENSG00000109805	0	474	100	474	0	1	-2	1/-2
ENSG00000145907	ENSG00000138757	8.66e-144	142	80.986	115	27	3	1	3/1
ENSG00000197275	ENSG00000265817	0	719	100	719	0	3	1	3/1
ENSG00000171916	ENSG00000168961	0	322	94.72	305	17	1	2	1/2
ENSG00000171916	ENSG00000168961	0	322	94.72	305	17	1	2	1/2
ENSG00000188152	ENSG00000130950	0	307	98.371	302	5	2	1	2/1
ENSG00000185926	ENSG00000258817	1.3e-156	262	84.351	221	41	1	3	1/3
ENSG00000178802	ENSG00000178761	0	744	100	744	0	-2	2	-2/2
ENSG00000187527	ENSG00000127249	0	108	80.556	87	21	2	3	2/3
ENSG00000237247	ENSG00000205718	3.09e-179	257	99.222	255	2	-1	-3	-1/-3
ENSG00000237247	ENSG00000182315	1.92e-177	257	98.444	253	4	-1	-3	-1/-3
ENSG00000237247	ENSG00000182315	1.3e-160	257	98.444	253	4	2	3	2/3
ENSG00000179914	ENSG00000158764	0	283	88.693	251	32	3	2	3/2
ENSG00000145194	ENSG00000163888	3.42e-84	124	100	124	0	-2	1	-2/1
ENSG00000131584	ENSG00000114331	1.81e-67	122	81.148	99	23	3	1	3/1
ENSG00000178809	ENSG00000155428	0	345	99.42	343	2	-2	-3	-2/-3
ENSG00000186599	ENSG00000186562	4.36e-74	110	100	110	0	2	1	2/1
ENSG00000221926	ENSG00000108448	0	447	97.763	437	10	3	2	3/2
ENSG00000188467	ENSG00000104177	0	222	97.297	216	6	-2	1	-2/1
ENSG00000188467	ENSG00000104177	1.61e-130	222	97.297	216	6	-2	2	-2/2
ENSG00000183682	ENSG00000116985	0	325	95.692	311	14	-3	-1	-3/-1
ENSG00000187630	ENSG00000157326	0	235	91.064	214	21	1	3	1/3
ENSG00000122824	ENSG00000196368	8.89e-136	177	96.045	170	7	-3	-2	-3/-2
ENSG00000196961	ENSG00000183020	0	649	88.906	577	72	2	1	2/1
ENSG00000189369	ENSG00000103342	0	439	96.355	423	16	2	1	2/1
ENSG00000189369	ENSG00000103342	0	439	96.355	423	16	2	3	2/3
ENSG00000206073	ENSG00000057149	0	583	91.767	535	48	1	2	1/2
ENSG00000197165	ENSG00000196502	0	279	90.681	253	26	3	2	3/2
ENSG00000010379	ENSG00000132164	0	241	81.328	196	45	3	1	3/1
ENSG00000198648	ENSG00000172939	0	368	83.424	307	61	2	1	2/1
ENSG00000172367	ENSG00000248712	5.45e-119	170	100	170	0	-2	3	-2/3
ENSG00000172367	ENSG00000248712	1.66e-116	170	100	170	0	3	-2	3/-2
ENSG00000140688	ENSG00000140675	2.95e-122	154	99.351	153	1	-1	2	-1/2
ENSG00000154258	ENSG00000141338	0	427	87.354	373	54	3	1	3/1
ENSG00000054690	ENSG00000100564	1.96e-64	100	100	100	0	-3	2	-3/2
ENSG00000054690	ENSG00000100564	7.57e-61	100	100	100	0	-1	3	-1/3
ENSG00000054690	ENSG00000100564	1.04e-60	100	100	100	0	3	-1	3/-1
ENSG00000054690	ENSG00000100564	5.09e-60	100	100	100	0	1	-2	1/-2
ENSG00000054690	ENSG00000100564	1.81e-59	100	100	100	0	-2	1	-2/1
ENSG00000054690	ENSG00000100564	4.7e-55	100	100	100	0	2	-3	2/-3
ENSG00000189152	ENSG00000154016	1.47e-98	154	98.052	151	3	3	2	3/2
ENSG00000186092	ENSG00000176695	0	351	99.145	348	3	1	3	1/3
ENSG00000162896	ENSG00000136213	2e-68	101	87.129	88	13	-3	1	-3/1
ENSG00000135702	ENSG00000183196	0	364	86.538	315	49	1	3	1/3
ENSG00000184486	ENSG00000196767	2.28e-71	144	80.556	116	28	-3	-1	-3/-1
ENSG00000188375	ENSG00000132475	0	129	96.899	125	4	1	2	1/2
ENSG00000188372	ENSG00000146707	2.12e-126	111	98.198	109	2	-3	-1	-3/-1
ENSG00000113460	ENSG00000113456	1.6e-63	104	100	104	0	-2	1	-2/1
ENSG00000170298	ENSG00000168961	0	263	92.776	244	19	2	1	2/1
ENSG00000170298	ENSG00000171916	0	207	98.068	203	4	3	1	3/1
ENSG00000241484	ENSG00000248405	0	269	100	269	0	1	3	1/3
ENSG00000167720	ENSG00000167721	0	243	99.588	242	1	2	-2	2/-2
ENSG00000189190	ENSG00000198482	0	316	87.658	277	39	1	3	1/3
ENSG00000189190	ENSG00000213799	0	152	80.921	123	29	1	3	1/3
ENSG00000214300	ENSG00000136206	0	121	88.43	107	14	3	1	3/1
ENSG00000214300	ENSG00000170092	1.99e-173	163	86.503	141	22	-1	-2	-1/-2
ENSG00000242515	ENSG00000242366	0	447	93.512	418	29	-1	-3	-1/-3
ENSG00000204481	ENSG00000116721	0	486	96.091	467	19	-1	-3	-1/-3
ENSG00000204481	ENSG00000120952	0	547	92.505	506	41	2	1	2/1
ENSG00000184302	ENSG00000138083	1.39e-127	209	86.603	181	28	2	1	2/1
ENSG00000184083	ENSG00000048828	0	130	80.769	105	25	1	3	1/3
ENSG00000076685	ENSG00000148842	0	528	100	528	0	-1	1	-1/1
ENSG00000070476	ENSG00000198455	0	311	85.209	265	46	1	2	1/2
ENSG00000168930	ENSG00000182053	0	582	95.533	556	26	-1	-3	-1/-3
ENSG00000196565	ENSG00000213934	1.3e-124	195	97.949	191	4	1	3	1/3
ENSG00000186432	ENSG00000102753	0	523	85.851	449	74	1	2	1/2
ENSG00000186364	ENSG00000131788	9.67e-100	143	100	143	0	-2	2	-2/2
ENSG00000186364	ENSG00000131788	6.01e-94	143	100	143	0	2	-2	2/-2
ENSG00000186364	ENSG00000131788	9.68e-92	143	100	143	0	3	-3	3/-3
ENSG00000186364	ENSG00000131788	8.26e-90	143	100	143	0	-3	3	-3/3
ENSG00000182053	ENSG00000204449	0	511	95.108	486	25	1	3	1/3
ENSG00000187325	ENSG00000273841	1.16e-117	137	90.511	124	13	3	1	3/1
ENSG00000157823	ENSG00000250021	0	584	98.801	577	7	-3	-2	-3/-2
ENSG00000157823	ENSG00000177879	3.28e-108	192	84.375	162	30	1	3	1/3
ENSG00000058404	ENSG00000070808	0	476	85.714	408	68	2	1	2/1
ENSG00000129993	ENSG00000079102	0	211	86.73	183	28	2	1	2/1
ENSG00000215695	ENSG00000197312	0	441	100	441	0	-2	-1	-2/-1
ENSG00000185236	ENSG00000103769	1.16e-103	155	95.484	148	7	3	1	3/1
ENSG00000065923	ENSG00000198689	0	204	82.843	169	35	3	1	3/1
ENSG00000156049	ENSG00000088256	0	352	82.386	290	62	2	3	2/3
ENSG00000125498	ENSG00000167633	0	230	83.043	191	39	2	1	2/1
ENSG00000196735	ENSG00000237541	0	323	85.449	276	47	-2	-1	-2/-1
ENSG00000008256	ENSG00000108669	0	363	87.328	317	46	3	2	3/2
ENSG00000204510	ENSG00000182330	0	383	99.739	382	1	-3	-2	-3/-2
ENSG00000244734	ENSG00000223609	1.73e-87	161	85.093	137	24	-3	-1	-3/-1
ENSG00000177688	ENSG00000188612	2.9e-167	137	86.131	118	19	2	1	2/1
ENSG00000177688	ENSG00000188612	1.14e-161	137	86.131	118	19	-2	-3	-2/-3
ENSG00000160868	ENSG00000160870	0	505	88.515	447	58	2	1	2/1
ENSG00000160868	ENSG00000282301	0	499	88.377	441	58	2	1	2/1
ENSG00000102053	ENSG00000149289	0	258	83.333	215	43	2	1	2/1
ENSG00000160200	ENSG00000274276	0	749	100	749	0	2	1	2/1
ENSG00000182580	ENSG00000133216	0	401	83.541	335	66	3	2	3/2
ENSG00000182580	ENSG00000133216	0	401	83.541	335	66	3	1	3/1
ENSG00000186393	ENSG00000171446	1.49e-174	322	80.745	260	62	2	3	2/3
ENSG00000167850	ENSG00000167851	7.28e-72	138	80.435	111	27	2	3	2/3
ENSG00000167850	ENSG00000167851	7.28e-72	138	80.435	111	27	2	1	2/1
ENSG00000188153	ENSG00000187498	0	230	83.478	192	38	2	3	2/3
ENSG00000180425	ENSG00000076053	2.71e-88	129	100	129	0	-2	2	-2/2
ENSG00000180425	ENSG00000076053	2.31e-86	129	100	129	0	2	-2	2/-2
ENSG00000180425	ENSG00000076053	1.33e-75	129	100	129	0	1	-1	1/-1
ENSG00000183706	ENSG00000176294	6.07e-150	309	85.761	265	44	2	1	2/1
ENSG00000198466	ENSG00000173480	0	745	91.812	684	61	1	2	1/2
ENSG00000177300	ENSG00000151718	0	635	100	635	0	-1	3	-1/3
ENSG00000177300	ENSG00000185758	1.63e-134	203	90.148	183	20	3	2	3/2
ENSG00000183054	ENSG00000015568	0	946	100	946	0	-2	-3	-2/-3
ENSG00000183054	ENSG00000169629	0	802	99.751	800	2	3	1	3/1
ENSG00000179750	ENSG00000128383	8.35e-173	229	93.886	215	14	1	3	1/3
ENSG00000258588	ENSG00000258659	0	550	100	550	0	3	2	3/2
ENSG00000160870	ENSG00000160868	0	506	88.538	448	58	2	3	2/3
ENSG00000131653	ENSG00000167971	4.74e-161	262	100	262	0	2	-3	2/-3
ENSG00000197479	ENSG00000120328	0	672	89.583	602	70	2	1	2/1
ENSG00000162194	ENSG00000278615	3.03e-127	189	100	189	0	1	3	1/3
ENSG00000183785	ENSG00000198033	0	437	91.533	400	37	2	1	2/1
ENSG00000276368	ENSG00000196747	1.96e-57	126	96.032	121	5	2	1	2/1
ENSG00000198429	ENSG00000171295	0	307	86.319	265	42	-1	-3	-1/-3
ENSG00000198429	ENSG00000197054	1.54e-82	132	84.091	111	21	2	1	2/1
ENSG00000198390	ENSG00000182816	5.6e-115	174	91.379	159	15	2	3	2/3
ENSG00000182783	ENSG00000203661	0	336	99.405	334	2	-2	-3	-2/-3
ENSG00000249471	ENSG00000083812	0	333	93.093	310	23	3	2	3/2
ENSG00000177693	ENSG00000176695	0	351	99.145	348	3	1	3	1/3
ENSG00000112144	ENSG00000111837	0	305	83.934	256	49	3	1	3/1
ENSG00000205212	ENSG00000170160	4.27e-97	163	95.706	156	7	1	2	1/2
ENSG00000206181	ENSG00000183791	0	269	82.156	221	48	-2	-3	-2/-3
ENSG00000206181	ENSG00000274744	0	269	82.156	221	48	-2	-3	-2/-3
ENSG00000142453	ENSG00000130733	4.97e-138	245	100	245	0	-1	2	-1/2
ENSG00000184611	ENSG00000173826	0	325	86.769	282	43	2	3	2/3
ENSG00000187243	ENSG00000154545	0	612	100	612	0	1	2	1/2
ENSG00000261509	ENSG00000275034	0	491	100	491	0	-3	-1	-3/-1
ENSG00000261509	ENSG00000205457	0	491	100	491	0	-3	-1	-3/-1
ENSG00000168903	ENSG00000113303	0	182	82.967	151	31	2	3	2/3
ENSG00000185829	ENSG00000228696	4.42e-161	245	100	245	0	-1	-2	-1/-2
ENSG00000183303	ENSG00000182334	2.81e-118	113	83.186	94	19	1	2	1/2
ENSG00000183303	ENSG00000182334	2.82e-118	113	83.186	94	19	1	3	1/3
ENSG00000164066	ENSG00000112096	0	188	80.851	152	36	-2	-1	-2/-1
ENSG00000164066	ENSG00000151131	0	126	80.159	101	25	-3	-2	-3/-2
ENSG00000104938	ENSG00000090659	5.27e-174	348	81.609	284	64	-1	-2	-1/-2
ENSG00000176490	ENSG00000165023	2.83e-101	126	86.508	109	17	2	1	2/1
ENSG00000181638	ENSG00000264668	0	471	100	471	0	2	1	2/1
ENSG00000157349	ENSG00000168872	0	475	96.842	460	15	3	1	3/1
ENSG00000136197	ENSG00000256646	0	549	100	549	0	1	2	1/2
ENSG00000196620	ENSG00000171234	0	295	82.712	244	51	-2	-1	-2/-1
ENSG00000104369	ENSG00000149596	1.23e-167	162	80.864	131	31	3	1	3/1
ENSG00000221826	ENSG00000243137	0	476	89.706	427	49	-2	-3	-2/-3
ENSG00000141404	ENSG00000154889	0	634	100	634	0	-2	1	-2/1
ENSG00000136487	ENSG00000213218	1.88e-179	206	81.068	167	39	-1	-3	-1/-3
ENSG00000197557	ENSG00000196659	0	673	95.097	640	33	2	3	2/3
ENSG00000186564	ENSG00000251493	3.23e-68	105	98.095	103	2	2	1	2/1
ENSG00000186564	ENSG00000187140	1.61e-62	104	91.346	95	9	2	1	2/1
ENSG00000197838	ENSG00000255974	0	307	91.205	280	27	-1	-2	-1/-2
ENSG00000197838	ENSG00000198077	0	489	91.207	446	43	1	3	1/3
ENSG00000170917	ENSG00000138685	6.75e-139	196	98.98	194	2	-2	2	-2/2
ENSG00000101558	ENSG00000140526	1.16e-149	106	95.283	101	5	-2	1	-2/1
ENSG00000196387	ENSG00000214029	1.53e-165	242	100	242	0	-2	2	-2/2
ENSG00000196387	ENSG00000214029	5.45e-165	242	100	242	0	-1	1	-1/1
ENSG00000196387	ENSG00000214029	5.46e-165	242	100	242	0	1	-2	1/-2
ENSG00000196387	ENSG00000214029	1.53e-161	242	100	242	0	2	-3	2/-3
ENSG00000196387	ENSG00000214029	1.31e-155	242	100	242	0	3	-1	3/-1
ENSG00000186480	ENSG00000125629	1.29e-89	185	84.324	156	29	2	3	2/3
ENSG00000184160	ENSG00000150594	1.88e-99	119	81.513	97	22	3	1	3/1
ENSG00000244509	ENSG00000243811	9.26e-162	125	82.4	103	22	1	2	1/2
ENSG00000244509	ENSG00000128394	0	159	81.761	130	29	1	3	1/3
ENSG00000074047	ENSG00000106571	0	201	82.587	166	35	1	2	1/2
ENSG00000197584	ENSG00000275163	0	365	100	365	0	3	2	3/2
ENSG00000198807	ENSG00000125813	3.56e-82	146	80.822	118	28	-1	-2	-1/-2
ENSG00000183793	ENSG00000214940	0	319	98.433	314	5	-3	-1	-3/-1
ENSG00000155111	ENSG00000132964	0	371	91.914	341	30	1	3	1/3
ENSG00000107937	ENSG00000148377	0	311	100	311	0	3	-2	3/-2
ENSG00000075391	ENSG00000136848	0	117	84.615	99	18	2	1	2/1
ENSG00000185963	ENSG00000151746	0	185	89.189	165	20	3	2	3/2
ENSG00000196329	ENSG00000281887	0	355	100	355	0	2	3	2/3
ENSG00000196126	ENSG00000198502	0	332	87.952	292	40	-2	-1	-2/-1
ENSG00000065135	ENSG00000127955	0	319	91.85	293	26	3	2	3/2
ENSG00000148704	ENSG00000116035	2.62e-55	105	85.714	90	15	1	3	1/3
ENSG00000102290	ENSG00000099715	0	910	98.242	894	16	3	2	3/2
ENSG00000108001	ENSG00000164330	0	267	93.633	250	17	2	3	2/3
ENSG00000019995	ENSG00000175029	0	622	100	622	0	-2	2	-2/2
ENSG00000019995	ENSG00000175029	0	622	100	622	0	1	-3	1/-3
ENSG00000019995	ENSG00000175029	0	622	100	622	0	-1	1	-1/1
ENSG00000104827	ENSG00000213030	1.49e-172	216	98.611	213	3	3	2	3/2
ENSG00000132681	ENSG00000163399	0	460	83.043	382	78	1	2	1/2
ENSG00000198042	ENSG00000129696	0	257	100	257	0	1	-1	1/-1
ENSG00000198042	ENSG00000129696	0	257	100	257	0	-2	3	-2/3
ENSG00000196550	ENSG00000188610	9.32e-95	155	97.419	151	4	3	1	3/1
ENSG00000185013	ENSG00000250741	0	406	100	406	0	1	2	1/2
ENSG00000196678	ENSG00000005187	1.46e-153	234	99.145	232	2	-3	2	-3/2
ENSG00000112305	ENSG00000112309	0	519	100	519	0	-2	3	-2/3
ENSG00000196805	ENSG00000241794	5.03e-115	150	90	135	15	1	2	1/2
ENSG00000196805	ENSG00000203785	4.25e-88	148	88.514	131	17	3	2	3/2
ENSG00000165125	ENSG00000127412	0	523	81.262	425	98	1	2	1/2
ENSG00000100146	ENSG00000125398	1.02e-127	128	89.062	114	14	2	1	2/1
ENSG00000142615	ENSG00000215704	1.05e-164	258	90.31	233	25	-2	-3	-2/-3
ENSG00000126070	ENSG00000092847	0	708	88.842	629	79	2	3	2/3
ENSG00000125551	ENSG00000183281	0	388	99.742	387	1	2	1	2/1
ENSG00000125551	ENSG00000122194	0	179	89.385	160	19	-3	-2	-3/-2
ENSG00000143515	ENSG00000104043	0	110	88.182	97	13	1	2	1/2
ENSG00000143515	ENSG00000104043	0	110	88.182	97	13	1	2	1/2
ENSG00000164651	ENSG00000217236	1.22e-103	123	96.748	119	4	2	1	2/1
ENSG00000186803	ENSG00000234829	0	274	94.161	258	16	-3	-2	-3/-2
ENSG00000186803	ENSG00000236637	1.54e-179	282	93.262	263	19	1	2	1/2
ENSG00000122435	ENSG00000122477	1.06e-94	174	92.529	161	13	2	-2	2/-2
ENSG00000085265	ENSG00000160339	2.43e-169	234	80.769	189	45	3	2	3/2
ENSG00000143185	ENSG00000143184	2.08e-119	188	95.745	180	8	-2	-3	-2/-3
ENSG00000173535	ENSG00000173530	1.71e-76	111	80.18	89	22	3	1	3/1
ENSG00000011478	ENSG00000138600	9.31e-84	106	81.132	86	20	1	3	1/3
ENSG00000203785	ENSG00000241794	1.35e-124	166	90.964	151	15	1	2	1/2
ENSG00000188603	ENSG00000261832	0	292	100	292	0	-3	-2	-3/-2
ENSG00000172426	ENSG00000096080	1.29e-151	215	95.349	205	10	-2	1	-2/1
ENSG00000196912	ENSG00000135976	0	762	98.95	754	8	1	2	1/2
ENSG00000221995	ENSG00000196535	0	465	100	465	0	3	2	3/2
ENSG00000221995	ENSG00000196535	0	465	100	465	0	3	2	3/2
ENSG00000122194	ENSG00000125551	0	179	89.385	160	19	-2	-3	-2/-3
ENSG00000122194	ENSG00000183281	0	179	88.827	159	20	-2	-3	-2/-3
ENSG00000162520	ENSG00000162521	1.87e-105	125	99.2	124	1	1	-3	1/-3
ENSG00000203859	ENSG00000203857	0	440	84.773	373	67	-1	-2	-1/-2
ENSG00000198835	ENSG00000182963	3.77e-103	106	81.132	86	20	2	3	2/3
ENSG00000106689	ENSG00000143355	4.66e-137	142	85.915	122	20	2	3	2/3
ENSG00000106689	ENSG00000143355	4.66e-137	142	85.915	122	20	2	1	2/1
ENSG00000160803	ENSG00000135018	5.83e-161	130	86.154	112	18	1	3	1/3
ENSG00000160803	ENSG00000188021	1.25e-154	130	81.538	106	24	1	2	1/2
ENSG00000181218	ENSG00000277075	3.67e-64	103	100	103	0	3	1	3/1
ENSG00000196406	ENSG00000198021	3.08e-97	214	83.645	179	35	-1	-2	-1/-2
ENSG00000196406	ENSG00000203926	3.08e-97	214	83.645	179	35	-1	-2	-1/-2
ENSG00000203926	ENSG00000196406	3.13e-109	214	83.645	179	35	-2	-1	-2/-1
ENSG00000143630	ENSG00000138622	0	390	83.333	325	65	3	2	3/2
ENSG00000143630	ENSG00000164588	0	371	83.019	308	63	3	2	3/2
ENSG00000182712	ENSG00000214827	2.31e-90	152	99.342	151	1	-3	-1	-3/-1
ENSG00000188603	ENSG00000261832	0	292	100	292	0	-3	-2	-3/-2
ENSG00000163565	ENSG00000163564	4.57e-178	122	80.328	98	24	2	3	2/3
ENSG00000101182	ENSG00000154611	3.85e-126	219	86.758	190	29	2	1	2/1
ENSG00000177272	ENSG00000111262	0	174	82.184	143	31	3	1	3/1
ENSG00000177272	ENSG00000182255	5.56e-173	147	89.796	132	15	3	2	3/2
ENSG00000188394	ENSG00000011454	0	371	100	371	0	-3	-2	-3/-2
ENSG00000188394	ENSG00000011454	0	371	100	371	0	-1	-3	-1/-3
ENSG00000143801	ENSG00000080815	1.84e-146	237	81.435	193	44	2	3	2/3
ENSG00000143184	ENSG00000143185	5.97e-119	188	95.745	180	8	-3	-2	-3/-2
ENSG00000203857	ENSG00000203859	0	439	83.827	368	71	1	3	1/3
ENSG00000081248	ENSG00000157388	0	318	88.679	282	36	3	1	3/1
ENSG00000081248	ENSG00000157388	0	318	88.679	282	36	3	2	3/2
ENSG00000092847	ENSG00000123908	0	856	82.477	706	150	1	3	1/3
ENSG00000107147	ENSG00000162687	0	480	82.292	395	85	2	1	2/1
ENSG00000203880	ENSG00000168300	7.01e-123	194	83.505	162	32	2	3	2/3
ENSG00000107187	ENSG00000121454	9.39e-141	126	80.952	102	24	3	2	3/2
ENSG00000203950	ENSG00000134590	1.1e-139	186	93.548	174	12	-3	-1	-3/-1
ENSG00000203950	ENSG00000212747	1.68e-137	201	91.045	183	18	-3	-2	-3/-2
ENSG00000072422	ENSG00000008853	0	142	92.254	131	11	1	2	1/2
ENSG00000000460	ENSG00000000457	0	314	98.726	310	4	-3	3	-3/3
ENSG00000196663	ENSG00000156381	2.58e-152	240	100	240	0	-2	1	-2/1
ENSG00000196663	ENSG00000156381	7.85e-142	240	100	240	0	3	-1	3/-1
ENSG00000196663	ENSG00000156381	1.37e-124	240	100	240	0	1	-2	1/-2
ENSG00000116985	ENSG00000183682	0	331	95.77	317	14	-1	-3	-1/-3
ENSG00000244474	ENSG00000240224	0	781	95.519	746	35	2	1	2/1
ENSG00000203618	ENSG00000184702	1.79e-86	125	100	125	0	-3	-1	-3/-1
ENSG00000203618	ENSG00000184702	1.79e-86	125	100	125	0	-3	-1	-3/-1
ENSG00000198961	ENSG00000181191	6.04e-114	129	89.922	116	13	1	2	1/2
ENSG00000124233	ENSG00000124157	0	409	80.44	329	80	-3	-2	-3/-2
ENSG00000198173	ENSG00000189132	0	175	81.143	142	33	1	2	1/2
ENSG00000198173	ENSG00000185448	0	174	84.483	147	27	-2	-1	-2/-1
ENSG00000035403	ENSG00000185009	0	369	100	369	0	-1	2	-1/2
ENSG00000184905	ENSG00000133142	5.37e-106	145	80	116	29	3	2	3/2
ENSG00000143556	ENSG00000184330	8.59e-81	145	88.276	128	17	2	1	2/1
ENSG00000180777	ENSG00000148513	0	286	85.664	245	41	-2	-3	-2/-3
ENSG00000133169	ENSG00000133134	1.58e-79	105	95.238	100	5	1	2	1/2
ENSG00000133169	ENSG00000133134	1.57e-79	105	95.238	100	5	1	2	1/2
ENSG00000143632	ENSG00000159251	0	378	98.942	374	4	2	3	2/3
ENSG00000143632	ENSG00000107796	0	378	97.884	370	8	2	1	2/1
ENSG00000158445	ENSG00000182674	0	481	90.644	436	45	2	1	2/1
ENSG00000172014	ENSG00000260691	0	433	99.538	431	2	1	3	1/3
ENSG00000172014	ENSG00000276203	0	433	99.076	429	4	1	3	1/3
ENSG00000188219	ENSG00000196834	0	1326	96.983	1286	40	1	3	1/3
ENSG00000188219	ENSG00000196604	0	1178	98.642	1162	16	1	2	1/2
ENSG00000136931	ENSG00000116833	3.77e-155	121	89.256	108	13	3	1	3/1
ENSG00000080910	ENSG00000244414	0	172	98.256	169	3	-1	-3	-1/-3
ENSG00000080910	ENSG00000134389	3.31e-132	177	83.051	147	30	-1	-3	-1/-3
ENSG00000162727	ENSG00000228198	0	313	92.971	291	22	1	2	1/2
ENSG00000116785	ENSG00000134365	0	154	90.909	140	14	-3	-2	-3/-2
ENSG00000148513	ENSG00000180777	0	286	83.566	239	47	-1	-3	-1/-3
ENSG00000213648	ENSG00000261052	0	426	99.531	424	2	-1	-2	-1/-2
ENSG00000007341	ENSG00000134245	0	668	99.551	665	3	-2	3	-2/3
ENSG00000240224	ENSG00000243135	0	781	96.287	752	29	1	2	1/2
ENSG00000240224	ENSG00000244474	0	781	95.519	746	35	1	2	1/2
ENSG00000112175	ENSG00000101144	3.19e-171	115	83.478	96	19	1	3	1/3
ENSG00000175265	ENSG00000215252	0	258	100	258	0	-3	-1	-3/-1
ENSG00000025800	ENSG00000196911	0	260	93.462	243	17	1	2	1/2
ENSG00000025800	ENSG00000196911	0	260	93.462	243	17	1	2	1/2
ENSG00000188153	ENSG00000187498	0	230	83.478	192	38	2	3	2/3
ENSG00000187140	ENSG00000186564	6.91e-63	104	91.346	95	9	1	2	1/2
ENSG00000116903	ENSG00000010072	3.29e-127	142	100	142	0	-3	2	-3/2
ENSG00000240038	ENSG00000243480	0	537	95.531	513	24	-2	-1	-2/-1
ENSG00000164430	ENSG00000215193	1.14e-65	105	83.81	88	17	3	2	3/2
ENSG00000116191	ENSG00000136828	0	212	82.547	175	37	3	2	3/2
ENSG00000221866	ENSG00000076356	0	726	81.818	594	132	1	3	1/3
ENSG00000172476	ENSG00000102128	0	242	98.347	238	4	2	3	2/3
ENSG00000183206	ENSG00000278522	0	362	97.514	353	9	-3	-1	-3/-1
ENSG00000183206	ENSG00000166351	0	536	96.455	517	19	1	2	1/2
ENSG00000184330	ENSG00000143556	8.5e-81	145	88.276	128	17	1	2	1/2
ENSG00000131503	ENSG00000254996	0	840	100	840	0	3	2	3/2
ENSG00000124177	ENSG00000171316	0	504	84.325	425	79	2	3	2/3
ENSG00000124177	ENSG00000100888	0	508	83.465	424	84	2	1	2/1
ENSG00000168765	ENSG00000134184	0	306	87.255	267	39	-3	-1	-3/-1
ENSG00000213714	ENSG00000124103	1.97e-127	228	90.351	206	22	1	3	1/3
ENSG00000171345	ENSG00000128422	2.69e-82	113	80.531	91	22	-2	-3	-2/-3
ENSG00000143443	ENSG00000197622	1.54e-88	141	100	141	0	3	-1	3/-1
ENSG00000102030	ENSG00000156269	2.2199999999999998e-95	117	94.017	110	7	1	3	1/3
ENSG00000065243	ENSG00000123143	0	332	80.422	267	65	3	2	3/2
ENSG00000172260	ENSG00000180398	0	126	82.54	104	22	-3	-1	-3/-1
ENSG00000254685	ENSG00000259030	1.93e-81	135	94.815	128	7	2	3	2/3
ENSG00000198889	ENSG00000198354	0	471	86.837	409	62	1	3	1/3
ENSG00000198668	ENSG00000160014	1.25e-98	173	90.751	157	16	3	2	3/2
ENSG00000102359	ENSG00000102362	0	432	100	432	0	3	-1	3/-1
ENSG00000102359	ENSG00000102362	0	432	100	432	0	1	-2	1/-2
ENSG00000124103	ENSG00000213714	2.73e-115	228	90.351	206	22	3	1	3/1
ENSG00000196747	ENSG00000196787	2.06e-76	123	92.683	114	9	3	1	3/1
ENSG00000196747	ENSG00000233822	5.92e-74	109	99.083	108	1	3	-1	3/-1
ENSG00000066382	ENSG00000186732	4.24e-175	286	81.119	232	54	1	2	1/2
ENSG00000198573	ENSG00000196406	2.3e-67	129	97.674	126	3	1	2	1/2
ENSG00000198573	ENSG00000198021	4e-62	129	96.124	124	5	-1	-2	-1/-2
ENSG00000092607	ENSG00000112837	7.54e-158	234	85.47	200	34	2	3	2/3
ENSG00000007341	ENSG00000134245	0	668	99.551	665	3	-2	3	-2/3
ENSG00000170074	ENSG00000182230	0	136	97.794	133	3	3	1	3/1
ENSG00000168148	ENSG00000274750	2.28e-64	125	86.4	108	17	-3	-2	-3/-2
ENSG00000168148	ENSG00000278828	8.98e-79	127	96.85	123	4	1	2	1/2
ENSG00000197385	ENSG00000213799	0	122	81.148	99	23	-2	-3	-2/-3
ENSG00000148842	ENSG00000076685	0	528	100	528	0	1	-2	1/-2
ENSG00000148842	ENSG00000076685	0	528	100	528	0	1	-1	1/-1
ENSG00000151923	ENSG00000116001	0	247	86.235	213	34	1	3	1/3
ENSG00000167136	ENSG00000198917	1.98e-95	122	96.721	118	4	-3	2	-3/2
ENSG00000125484	ENSG00000125485	3.71e-68	122	100	122	0	2	-2	2/-2
ENSG00000125484	ENSG00000125485	3.71e-68	122	100	122	0	2	-1	2/-1
ENSG00000185303	ENSG00000122852	0	393	92.875	365	28	3	2	3/2
ENSG00000124615	ENSG00000146122	4.09e-155	237	100	237	0	3	-3	3/-3
ENSG00000124615	ENSG00000146122	5.19e-146	237	100	237	0	-1	3	-1/3
ENSG00000068383	ENSG00000148826	3.88e-63	100	100	100	0	1	-1	1/-1
ENSG00000068383	ENSG00000148826	1.9e-54	100	100	100	0	-1	1	-1/1
ENSG00000171357	ENSG00000085998	7.69e-138	199	100	199	0	3	-2	3/-2
ENSG00000139675	ENSG00000135486	3.03e-151	211	97.156	205	6	2	1	2/1
ENSG00000146221	ENSG00000178233	1.32e-145	234	100	234	0	2	-1	2/-1
ENSG00000197020	ENSG00000118620	0	591	80.88	478	113	-2	-1	-2/-1
ENSG00000181274	ENSG00000165879	7.17e-108	119	90.756	108	11	3	2	3/2
ENSG00000112144	ENSG00000111837	0	305	83.934	256	49	2	1	2/1
ENSG00000204065	ENSG00000196507	8.18e-130	215	83.721	180	35	-3	-2	-3/-2
ENSG00000204065	ENSG00000196507	3.45e-131	215	83.721	180	35	-3	-1	-3/-1
ENSG00000131721	ENSG00000203989	0	401	100	401	0	-2	-3	-2/-3
ENSG00000116478	ENSG00000196591	0	437	90.618	396	41	1	3	1/3
ENSG00000198205	ENSG00000198455	0	566	95.936	543	23	-3	-2	-3/-2
ENSG00000198205	ENSG00000070476	0	351	80.342	282	69	2	1	2/1
ENSG00000196911	ENSG00000162924	0	396	93.434	370	26	2	1	2/1
ENSG00000124157	ENSG00000124233	0	275	83.273	229	46	-3	-1	-3/-1
ENSG00000203722	ENSG00000131015	5.51e-129	222	88.288	196	26	1	3	1/3
ENSG00000203722	ENSG00000155918	2.7e-128	222	87.838	195	27	1	3	1/3
ENSG00000203722	ENSG00000155918	8.9e-128	222	87.838	195	27	-2	-1	-2/-1
ENSG00000117009	ENSG00000054277	0	504	100	504	0	-1	3	-1/3
ENSG00000196363	ENSG00000196981	0	320	87.188	279	41	1	2	1/2
ENSG00000054282	ENSG00000117020	1.76e-67	114	100	114	0	-1	1	-1/1
ENSG00000198642	ENSG00000003096	0	623	92.295	575	48	3	2	3/2
ENSG00000178761	ENSG00000178802	0	744	100	744	0	2	-2	2/-2
ENSG00000171943	ENSG00000266028	0	340	98.235	334	6	3	2	3/2
ENSG00000196361	ENSG00000162374	0	221	90.045	199	22	3	1	3/1
ENSG00000254415	ENSG00000105501	1.74e-146	222	98.198	218	4	3	1	3/1
ENSG00000143105	ENSG00000111262	8.54e-151	152	84.868	129	23	2	1	2/1
ENSG00000143105	ENSG00000177272	7.11e-149	148	87.838	130	18	2	3	2/3
ENSG00000213397	ENSG00000183479	0	184	100	184	0	3	1	3/1
ENSG00000274791	ENSG00000277203	1.54e-136	136	100	136	0	1	3	1/3
ENSG00000198380	ENSG00000131459	0	446	81.166	362	84	1	3	1/3
ENSG00000168118	ENSG00000213029	2.4e-145	215	100	215	0	2	3	2/3
ENSG00000197360	ENSG00000229676	0	611	97.381	595	16	1	3	1/3
ENSG00000143858	ENSG00000077157	0	703	100	703	0	2	-2	2/-2
ENSG00000097007	ENSG00000143322	0	470	88.298	415	55	3	1	3/1
ENSG00000077458	ENSG00000009780	1.75e-132	114	85.088	97	17	2	1	2/1
ENSG00000196313	ENSG00000272391	0	435	96.782	421	14	-3	-1	-3/-1
ENSG00000119285	ENSG00000116977	0	655	100	655	0	-3	1	-3/1
ENSG00000119285	ENSG00000116977	0	655	100	655	0	-3	3	-3/3
ENSG00000127603	ENSG00000151914	0	188	83.511	157	31	2	1	2/1
ENSG00000240849	ENSG00000124208	2.48e-157	231	100	231	0	2	1	2/1
ENSG00000203989	ENSG00000131721	0	401	100	401	0	-3	-2	-3/-2
ENSG00000169760	ENSG00000165246	0	357	81.793	292	65	3	1	3/1
ENSG00000150337	ENSG00000198019	0	198	98.99	196	2	-2	-1	-2/-1
ENSG00000150337	ENSG00000198019	6.13e-178	198	98.99	196	2	3	2	3/2
ENSG00000116726	ENSG00000204510	0	431	84.455	364	67	1	3	1/3
ENSG00000116726	ENSG00000204510	0	431	84.455	364	67	1	3	1/3
ENSG00000278828	ENSG00000203852	1.67e-86	137	99.27	136	1	2	1	2/1
ENSG00000278828	ENSG00000203811	1.67e-86	137	99.27	136	1	2	1	2/1
ENSG00000198380	ENSG00000131459	0	446	81.166	362	84	1	3	1/3
ENSG00000128335	ENSG00000100342	0	170	84.706	144	26	1	2	1/2
ENSG00000122136	ENSG00000171102	1.79e-142	229	94.323	216	13	-3	-2	-3/-2
ENSG00000101811	ENSG00000177613	0	216	86.111	186	30	2	1	2/1
ENSG00000203811	ENSG00000278828	2.31e-86	137	99.27	136	1	1	2	1/2
ENSG00000138161	ENSG00000213185	6.6e-74	119	95.798	114	5	2	3	2/3
ENSG00000197329	ENSG00000139946	0	411	81.752	336	75	3	2	3/2
ENSG00000137193	ENSG00000198355	2.7e-134	194	80.928	157	37	2	1	2/1
ENSG00000163216	ENSG00000241794	4.26e-108	160	89.375	143	17	2	1	2/1
ENSG00000107317	ENSG00000284341	1.07e-145	211	100	211	0	3	2	3/2
ENSG00000186340	ENSG00000137801	0	259	83.012	215	44	2	1	2/1
ENSG00000101109	ENSG00000104375	0	303	91.419	277	26	3	2	3/2
ENSG00000102362	ENSG00000102359	0	432	100	432	0	1	-3	1/-3
ENSG00000102362	ENSG00000102359	0	432	100	432	0	-1	3	-1/3
ENSG00000102362	ENSG00000102359	0	432	100	432	0	-2	1	-2/1
ENSG00000165841	ENSG00000138109	0	518	90.541	469	49	2	1	2/1
ENSG00000198471	ENSG00000175077	2.46e-96	127	92.126	117	10	-1	-2	-1/-2
ENSG00000130827	ENSG00000114554	0	623	83.949	523	100	2	1	2/1
ENSG00000130827	ENSG00000076356	0	272	80.147	218	54	2	3	2/3
ENSG00000166913	ENSG00000164924	5.15e-134	239	85.774	205	34	2	1	2/1
ENSG00000264343	ENSG00000134250	2.86e-171	246	97.561	240	6	1	3	1/3
ENSG00000196693	ENSG00000189180	0	812	92.611	752	60	2	1	2/1
ENSG00000196475	ENSG00000198814	0	556	88.309	491	65	1	3	1/3
ENSG00000107854	ENSG00000173273	0	383	86.162	330	53	2	3	2/3
ENSG00000188004	ENSG00000158714	0	327	99.388	325	2	2	-1	2/-1
ENSG00000196411	ENSG00000182580	0	392	81.888	321	71	2	3	2/3
ENSG00000198830	ENSG00000126814	0	177	85.876	152	25	2	1	2/1
ENSG00000174876	ENSG00000187733	0	538	100	538	0	-3	-1	-3/-1
ENSG00000162385	ENSG00000111196	4.83e-97	148	98.649	146	2	1	2	1/2
ENSG00000242366	ENSG00000244122	0	426	92.019	392	34	-3	-1	-3/-1
ENSG00000242366	ENSG00000241119	0	646	98.452	636	10	1	2	1/2
ENSG00000186288	ENSG00000184388	0	269	99.257	267	2	-1	-3	-1/-3
ENSG00000099284	ENSG00000113648	1.44e-151	116	84.483	98	18	1	2	1/2
ENSG00000272514	ENSG00000213204	0	666	100	666	0	2	3	2/3
ENSG00000143858	ENSG00000077157	0	703	100	703	0	3	-2	3/-2
ENSG00000096080	ENSG00000172426	4.84e-152	215	95.349	205	10	1	-2	1/-2
ENSG00000198874	ENSG00000277149	0	659	96.358	635	24	-3	-1	-3/-1
ENSG00000125356	ENSG00000125352	1.9e-73	113	100	113	0	1	-2	1/-2
ENSG00000125356	ENSG00000125352	3.32e-72	113	100	113	0	-3	1	-3/1
ENSG00000197183	ENSG00000101746	2.59e-85	115	81.739	94	21	3	2	3/2
ENSG00000214435	ENSG00000270316	0	753	99.602	750	3	3	2	3/2
ENSG00000244122	ENSG00000242366	0	426	92.019	392	34	-1	-3	-1/-3
ENSG00000166136	ENSG00000255339	1.93e-155	215	100	215	0	2	1	2/1
ENSG00000112208	ENSG00000112210	0	790	100	790	0	1	-2	1/-2
ENSG00000116459	ENSG00000116455	1.47e-74	126	88.095	111	15	1	-3	1/-3
ENSG00000102144	ENSG00000170950	0	421	87.173	367	54	3	1	3/1
ENSG00000196550	ENSG00000215784	0	347	98.559	342	5	-1	-3	-1/-3
ENSG00000196550	ENSG00000263513	0	347	98.559	342	5	-1	-2	-1/-2
ENSG00000184388	ENSG00000186288	0	269	99.257	267	2	-3	-1	-3/-1
ENSG00000117228	ENSG00000117226	0	398	88.191	351	47	2	3	2/3
ENSG00000054277	ENSG00000117009	0	504	100	504	0	3	-1	3/-1
ENSG00000172572	ENSG00000152270	0	128	82.031	105	23	2	3	2/3
ENSG00000162409	ENSG00000132356	0	243	82.716	201	42	1	3	1/3
ENSG00000076356	ENSG00000221866	0	634	84.227	534	100	3	1	3/1
ENSG00000076356	ENSG00000221866	0	634	84.227	534	100	3	2	3/2
ENSG00000102076	ENSG00000269433	0	419	96.181	403	16	-3	-1	-3/-1
ENSG00000156875	ENSG00000148110	0	374	84.225	315	59	2	3	2/3
ENSG00000143768	ENSG00000243709	0	335	95.821	321	14	2	3	2/3
ENSG00000204632	ENSG00000206503	0	317	83.912	266	51	1	3	1/3
ENSG00000158764	ENSG00000179914	0	283	88.693	251	32	2	3	2/3
ENSG00000189064	ENSG00000236362	6.53e-95	127	99.213	126	1	3	2	3/2
ENSG00000189064	ENSG00000274274	5.01e-92	127	98.425	125	2	3	2	3/2
ENSG00000198021	ENSG00000196406	3.13e-109	214	83.645	179	35	-2	-1	-2/-1
ENSG00000187733	ENSG00000237763	0	538	100	538	0	-1	-3	-1/-3
ENSG00000187733	ENSG00000174876	0	537	100	537	0	-1	-3	-1/-3
ENSG00000172426	ENSG00000096080	1.26e-151	215	95.349	205	10	-2	1	-2/1
ENSG00000166984	ENSG00000203690	0	361	97.784	353	8	3	1	3/1
ENSG00000160094	ENSG00000126746	6.17e-113	172	80.233	138	34	1	3	1/3
ENSG00000143842	ENSG00000134532	3.17e-78	115	82.609	95	20	2	1	2/1
ENSG00000168925	ENSG00000168928	4.86e-158	154	96.104	148	6	-3	-1	-3/-1
ENSG00000148826	ENSG00000163623	7.98e-90	122	82.787	101	21	3	1	3/1
ENSG00000148826	ENSG00000068383	3.47e-63	100	100	100	0	-1	1	-1/1
ENSG00000148826	ENSG00000068383	1.7e-54	100	100	100	0	1	-1	1/-1
ENSG00000185009	ENSG00000070718	0	426	83.333	355	71	2	1	2/1
ENSG00000162390	ENSG00000167080	0	105	81.905	86	19	1	-2	1/-2
ENSG00000102038	ENSG00000153147	0	753	86.321	650	103	2	1	2/1
ENSG00000065243	ENSG00000123143	0	332	80.422	267	65	3	2	3/2
ENSG00000188610	ENSG00000215784	0	460	98.261	452	8	-2	-3	-2/-3
ENSG00000188610	ENSG00000263513	0	159	98.742	157	2	-1	-3	-1/-3
ENSG00000108684	ENSG00000110881	0	160	85	136	24	1	2	1/2
ENSG00000221867	ENSG00000197172	0	466	96.996	452	14	2	3	2/3
ENSG00000198354	ENSG00000198889	0	437	86.041	376	61	3	1	3/1
ENSG00000213551	ENSG00000138286	2.27e-169	235	99.149	233	2	2	-1	2/-1
ENSG00000085998	ENSG00000171357	1.26e-137	199	100	199	0	-2	3	-2/3
ENSG00000167578	ENSG00000171570	1.07e-168	257	99.222	255	2	-1	-2	-1/-2
ENSG00000185668	ENSG00000198914	2.59e-62	142	91.549	130	12	-2	-3	-2/-3
ENSG00000198774	ENSG00000163428	1.68e-48	103	82.524	85	18	-2	3	-2/3
ENSG00000125352	ENSG00000125356	3.67e-73	113	100	113	0	-2	1	-2/1
ENSG00000120437	ENSG00000112096	0	278	99.281	276	2	2	-1	2/-1
ENSG00000120437	ENSG00000120438	1.74e-92	135	98.519	133	2	2	-2	2/-2
ENSG00000248405	ENSG00000241484	0	269	100	269	0	3	1	3/1
ENSG00000248405	ENSG00000241484	0	269	100	269	0	3	1	3/1
ENSG00000149658	ENSG00000185728	0	182	86.264	157	25	1	3	1/3
ENSG00000149658	ENSG00000185728	0	182	86.264	157	25	1	3	1/3
ENSG00000171102	ENSG00000122136	1.8e-142	229	94.323	216	13	-2	-3	-2/-3
ENSG00000119185	ENSG00000151693	0	736	100	736	0	2	-1	2/-1
ENSG00000278677	ENSG00000272196	2.62e-72	108	99.074	107	1	1	3	1/3
ENSG00000278677	ENSG00000203812	2.62e-72	108	99.074	107	1	1	3	1/3
ENSG00000196873	ENSG00000215126	0	560	99.286	556	4	3	2	3/2
ENSG00000196873	ENSG00000147996	0	597	99.33	593	4	-2	-1	-2/-1
ENSG00000067048	ENSG00000215301	0	493	95.132	469	24	1	3	1/3
ENSG00000197045	ENSG00000130755	3.84e-58	110	81.818	90	20	3	2	3/2
ENSG00000101204	ENSG00000120903	0	340	80.588	274	66	2	1	2/1
ENSG00000047410	ENSG00000116690	9.21e-131	116	100	116	0	-1	1	-1/1
ENSG00000047410	ENSG00000116690	9.8e-131	116	100	116	0	-1	1	-1/1
ENSG00000104818	ENSG00000267631	4.31e-113	169	98.817	167	2	2	1	2/1
ENSG00000104818	ENSG00000104827	8.39e-99	135	97.778	132	3	2	3	2/3
ENSG00000197959	ENSG00000079805	0	746	83.78	625	121	2	1	2/1
ENSG00000171116	ENSG00000268738	0	454	100	454	0	3	2	3/2
ENSG00000183305	ENSG00000268606	0	463	100	463	0	-1	-3	-1/-3
ENSG00000183305	ENSG00000268606	0	463	100	463	0	-1	-3	-1/-3
ENSG00000198865	ENSG00000250722	0	484	100	484	0	-2	1	-2/1
ENSG00000284741	ENSG00000128655	0	582	99.828	581	1	1	2	1/2
ENSG00000166275	ENSG00000270316	1.42e-68	115	100	115	0	2	1	2/1
ENSG00000162415	ENSG00000130449	0	193	86.01	166	27	3	1	3/1
ENSG00000148219	ENSG00000122484	2.38e-168	148	84.459	125	23	2	-1	2/-1
ENSG00000148219	ENSG00000112096	0	148	85.135	126	22	-2	-3	-2/-3
ENSG00000213185	ENSG00000138161	1.45e-74	119	95.798	114	5	3	2	3/2
ENSG00000198740	ENSG00000114853	1.82e-176	245	93.878	230	15	2	3	2/3
ENSG00000196787	ENSG00000196747	1.19e-75	123	92.683	114	9	1	3	1/3
ENSG00000196787	ENSG00000272196	9.76e-71	108	99.074	107	1	1	3	1/3
ENSG00000117500	ENSG00000122483	2.91e-66	126	97.619	123	3	-1	2	-1/2
ENSG00000112837	ENSG00000092607	6.34e-159	252	80.952	204	48	3	2	3/2
ENSG00000112837	ENSG00000092607	1.48e-156	252	80.952	204	48	3	1	3/1
ENSG00000133641	ENSG00000198707	5.24e-67	120	100	120	0	-3	3	-3/3
ENSG00000198019	ENSG00000150337	5.79e-179	196	98.98	194	2	1	3	1/3
ENSG00000116473	ENSG00000127314	4.75e-118	186	83.333	155	31	-2	-3	-2/-3
ENSG00000213923	ENSG00000283900	0	438	100	438	0	1	2	1/2
ENSG00000198898	ENSG00000116489	2.09e-164	288	86.806	250	38	2	1	2/1
ENSG00000196218	ENSG00000198626	0	122	87.705	107	15	1	3	1/3
ENSG00000135778	ENSG00000135749	3.82e-101	149	100	149	0	-1	3	-1/3
ENSG00000135778	ENSG00000135749	9.15e-100	149	100	149	0	2	-1	2/-1
ENSG00000135778	ENSG00000135749	5.25e-97	149	100	149	0	3	-2	3/-2
ENSG00000166160	ENSG00000269433	0	364	100	364	0	1	2	1/2
ENSG00000166160	ENSG00000268221	0	364	100	364	0	1	2	1/2
ENSG00000138316	ENSG00000156140	0	183	83.607	153	30	1	2	1/2
ENSG00000131015	ENSG00000155918	1.23e-154	244	90.164	220	24	-2	-1	-2/-1
ENSG00000107859	ENSG00000164093	3.4e-69	103	83.495	86	17	2	3	2/3
ENSG00000213029	ENSG00000168118	4.29e-146	215	100	215	0	3	2	3/2
ENSG00000025039	ENSG00000116954	0	336	87.798	295	41	2	1	2/1
ENSG00000196177	ENSG00000180398	7.01e-178	102	80.392	82	20	-2	-1	-2/-1
ENSG00000198074	ENSG00000227471	0	397	88.161	350	47	-2	-3	-2/-3
ENSG00000116191	ENSG00000136828	0	212	82.547	175	37	3	2	3/2
ENSG00000125430	ENSG00000153976	4.09e-140	274	93.066	255	19	-3	-2	-3/-2
ENSG00000215271	ENSG00000215277	1.15e-133	198	98.99	196	2	3	-3	3/-3
ENSG00000197013	ENSG00000213967	0	126	80.952	102	24	-2	-3	-2/-3
ENSG00000198917	ENSG00000167136	3.44e-92	122	96.721	118	4	2	-3	2/-3
ENSG00000157557	ENSG00000134954	9.56e-127	129	86.822	112	17	3	2	3/2
ENSG00000147224	ENSG00000229937	0	339	92.035	312	27	3	1	3/1
ENSG00000198961	ENSG00000181191	4.66e-114	129	89.922	116	13	1	2	1/2
ENSG00000213401	ENSG00000268606	0	415	84.578	351	64	-3	-1	-3/-1
ENSG00000000971	ENSG00000244414	2.04e-169	217	94.47	205	12	-2	-1	-2/-1
ENSG00000000971	ENSG00000244414	2.12e-165	217	94.47	205	12	2	3	2/3
ENSG00000203923	ENSG00000204363	0	206	89.806	185	21	3	2	3/2
ENSG00000203923	ENSG00000268988	0	137	87.591	120	17	2	1	2/1
ENSG00000172288	ENSG00000172352	0	725	100	725	0	3	2	3/2
ENSG00000197213	ENSG00000131848	0	353	80.737	285	68	-1	-3	-1/-3
ENSG00000196944	ENSG00000182783	0	321	89.72	288	33	-1	-2	-1/-2
ENSG00000198626	ENSG00000198838	0	389	85.861	334	55	3	1	3/1
ENSG00000198626	ENSG00000196218	0	129	87.597	113	16	3	1	3/1
ENSG00000120314	ENSG00000256453	0	320	100	320	0	3	-1	3/-1
ENSG00000214827	ENSG00000182712	5.09e-90	152	99.342	151	1	-1	-3	-1/-3
ENSG00000121933	ENSG00000282608	2.39e-98	164	98.78	162	2	-2	-1	-2/-1
ENSG00000116954	ENSG00000025039	0	336	87.798	295	41	1	2	1/2
ENSG00000121905	ENSG00000115756	2.4900000000000002e-123	196	94.388	185	11	1	3	1/3
ENSG00000058673	ENSG00000257315	0	950	100	950	0	1	2	1/2
ENSG00000058673	ENSG00000257315	0	950	100	950	0	1	2	1/2
ENSG00000198482	ENSG00000213799	0	205	80.488	165	40	1	3	1/3
ENSG00000198482	ENSG00000213799	0	205	80.488	165	40	1	3	1/3
ENSG00000075891	ENSG00000196092	2.78e-83	131	81.679	107	24	-1	-3	-1/-3
ENSG00000188931	ENSG00000143252	5.33e-122	142	99.296	141	1	-1	2	-1/2
ENSG00000134375	ENSG00000126768	5.95e-55	113	83.186	94	19	1	3	1/3
ENSG00000188828	ENSG00000145451	0	188	84.574	159	29	2	3	2/3
ENSG00000188828	ENSG00000145451	0	188	84.574	159	29	2	3	2/3
ENSG00000134698	ENSG00000092847	0	366	83.06	304	62	3	1	3/1
ENSG00000112246	ENSG00000159263	0	359	86.072	309	50	1	2	1/2
ENSG00000121481	ENSG00000204227	1.69e-123	151	84.106	127	24	1	2	1/2
ENSG00000198589	ENSG00000172915	0	175	80.571	141	34	2	1	2/1
ENSG00000165359	ENSG00000102786	0	245	84.49	207	38	2	3	2/3
ENSG00000124251	ENSG00000204070	7.93e-119	177	98.87	175	2	-2	2	-2/2
ENSG00000198355	ENSG00000137193	1.1e-129	183	81.967	150	33	1	2	1/2
ENSG00000124249	ENSG00000101098	9.42e-112	168	100	168	0	2	-3	2/-3
ENSG00000124249	ENSG00000101098	6.34e-107	168	100	168	0	-1	3	-1/3
ENSG00000124249	ENSG00000101098	3.64e-100	168	100	168	0	-3	2	-3/2
ENSG00000196767	ENSG00000184486	2.06e-69	132	81.061	107	25	-1	-3	-1/-3
ENSG00000196767	ENSG00000198914	8.25e-65	135	82.222	111	24	-1	-3	-1/-3
ENSG00000143171	ENSG00000186350	7.54e-169	203	89.163	181	22	1	2	1/2
ENSG00000196946	ENSG00000215372	0	616	95.455	588	28	-2	-3	-2/-3
ENSG00000198863	ENSG00000231925	6.51e-92	101	81.188	82	19	-1	1	-1/1
ENSG00000256980	ENSG00000135314	7.49e-97	133	83.459	111	22	3	1	3/1
ENSG00000056277	ENSG00000137871	0	209	85.167	178	31	2	1	2/1
ENSG00000163874	ENSG00000149289	2.16e-138	208	83.173	173	35	3	1	3/1
ENSG00000018625	ENSG00000163399	0	527	90.323	476	51	3	1	3/1
ENSG00000018625	ENSG00000163399	0	527	90.323	476	51	3	2	3/2
ENSG00000169418	ENSG00000159899	0	368	80.435	296	72	2	1	2/1
ENSG00000213281	ENSG00000174775	1.3e-100	193	84.456	163	30	3	2	3/2
ENSG00000162365	ENSG00000187048	0	528	94.886	501	27	2	3	2/3
ENSG00000111642	ENSG00000116254	0	529	88.658	469	60	3	2	3/2
ENSG00000189013	ENSG00000243772	2.18e-180	104	86.538	90	14	2	3	2/3
ENSG00000167165	ENSG00000243135	0	305	98.689	301	4	3	2	3/2
ENSG00000242498	ENSG00000250021	2.79e-179	225	100	225	0	-1	-2	-1/-2
ENSG00000280987	ENSG00000015479	0	727	100	727	0	3	1	3/1
ENSG00000280987	ENSG00000015479	0	727	100	727	0	3	1	3/1
ENSG00000134245	ENSG00000007341	0	668	99.551	665	3	3	-2	3/-2
ENSG00000127152	ENSG00000119866	0	114	87.719	100	14	2	1	2/1
ENSG00000086015	ENSG00000105613	0	540	82.222	444	96	2	1	2/1
ENSG00000086015	ENSG00000099308	0	376	80.851	304	72	2	1	2/1
ENSG00000154545	ENSG00000187243	0	612	100	612	0	2	1	2/1
ENSG00000126457	ENSG00000111218	0	339	81.711	277	62	1	2	1/2
ENSG00000156697	ENSG00000253797	0	266	90.602	241	25	-3	-2	-3/-2
ENSG00000145907	ENSG00000138757	2.06e-140	142	80.986	115	27	2	1	2/1
ENSG00000204397	ENSG00000137752	3.12e-81	134	92.537	124	10	-3	-2	-3/-2
ENSG00000149476	ENSG00000162144	9.28e-104	166	100	166	0	2	-1	2/-1
ENSG00000149476	ENSG00000162144	3.06e-94	166	100	166	0	-1	2	-1/2
ENSG00000172650	ENSG00000204172	0	351	96.866	340	11	-3	-2	-3/-2
ENSG00000172650	ENSG00000204149	0	297	95.96	285	12	2	1	2/1
ENSG00000198083	ENSG00000239886	1.54e-121	102	94.118	96	6	-1	-2	-1/-2
ENSG00000198502	ENSG00000196126	0	332	87.952	292	40	-1	-2	-1/-2
ENSG00000163283	ENSG00000163286	0	493	97.566	481	12	3	2	3/2
ENSG00000163283	ENSG00000163295	0	504	85.913	433	71	-1	-3	-1/-3
ENSG00000212710	ENSG00000150527	0	324	86.42	280	44	2	3	2/3
ENSG00000204657	ENSG00000204688	0	349	87.679	306	43	2	1	2/1
ENSG00000172780	ENSG00000261796	0	442	100	442	0	3	2	3/2
ENSG00000164330	ENSG00000221818	0	311	83.923	261	50	3	2	3/2
ENSG00000239306	ENSG00000248643	1.39e-84	143	100	143	0	-3	-2	-3/-2
ENSG00000138741	ENSG00000069018	0	422	84.123	355	67	3	2	3/2
ENSG00000196781	ENSG00000106829	0	360	96.667	348	12	1	3	1/3
ENSG00000196781	ENSG00000106829	0	360	96.667	348	12	1	2	1/2
ENSG00000120696	ENSG00000165572	0	653	81.93	535	118	-1	-3	-1/-3
ENSG00000066117	ENSG00000082014	0	105	80.952	85	20	3	2	3/2
ENSG00000081853	ENSG00000254245	0	412	100	412	0	2	3	2/3
ENSG00000198814	ENSG00000196475	0	457	85.339	390	67	-1	-3	-1/-3
ENSG00000187175	ENSG00000221864	6.13e-87	108	83.333	90	18	1	2	1/2
ENSG00000142634	ENSG00000115468	5.83e-64	130	84.615	110	20	3	1	3/1
ENSG00000135090	ENSG00000160551	0	350	83.143	291	59	3	1	3/1
ENSG00000215915	ENSG00000197785	0	290	87.586	254	36	3	2	3/2
ENSG00000215915	ENSG00000197785	0	290	87.586	254	36	3	2	3/2
ENSG00000221859	ENSG00000188155	2.6e-130	149	89.933	134	15	-2	-1	-2/-1
ENSG00000261052	ENSG00000213648	0	426	99.531	424	2	-2	-1	-2/-1
ENSG00000172352	ENSG00000172288	0	725	100	725	0	2	3	2/3
ENSG00000007923	ENSG00000041988	0	473	100	473	0	-1	2	-1/2
ENSG00000007923	ENSG00000041988	0	473	100	473	0	3	-1	3/-1
ENSG00000177710	ENSG00000164729	0	184	92.935	171	13	-2	-1	-2/-1
ENSG00000177710	ENSG00000259224	0	404	93.317	377	27	3	2	3/2
ENSG00000246705	ENSG00000272196	1.54e-70	118	97.458	115	3	2	3	2/3
ENSG00000125944	ENSG00000135316	0	404	84.406	341	63	2	1	2/1
ENSG00000213218	ENSG00000136488	2.12e-170	179	98.324	176	3	-1	-3	-1/-3
ENSG00000182583	ENSG00000205642	1.18e-173	129	93.023	120	9	-2	-1	-2/-1
ENSG00000065029	ENSG00000166478	0	217	82.949	180	37	3	1	3/1
ENSG00000169059	ENSG00000205642	0	165	97.576	161	4	-3	-2	-3/-2
ENSG00000133983	ENSG00000258644	4.13e-85	131	100	131	0	-3	-1	-3/-1
ENSG00000122824	ENSG00000196368	3.65e-134	177	96.045	170	7	-3	-2	-3/-2
ENSG00000212659	ENSG00000239886	2.21e-134	127	94.488	120	7	-1	-2	-1/-2
ENSG00000212899	ENSG00000212900	3.5e-66	127	88.189	112	15	1	3	1/3
ENSG00000205571	ENSG00000172062	0	192	100	192	0	3	1	3/1
ENSG00000221874	ENSG00000213799	0	218	82.11	179	39	3	1	3/1
ENSG00000221874	ENSG00000213799	0	218	82.11	179	39	3	1	3/1
ENSG00000144134	ENSG00000079974	0	241	98.755	238	3	3	2	3/2
ENSG00000205809	ENSG00000134545	0	162	90.123	146	16	1	2	1/2
ENSG00000182768	ENSG00000112378	0	229	85.59	196	33	-3	-2	-3/-2
ENSG00000008196	ENSG00000137203	8.95e-146	217	86.636	188	29	2	3	2/3
ENSG00000008196	ENSG00000137203	4.11e-143	217	86.636	188	29	2	3	2/3
ENSG00000168283	ENSG00000269897	0	334	99.701	333	1	1	3	1/3
ENSG00000168283	ENSG00000277258	2.38e-123	142	82.394	117	25	2	1	2/1
ENSG00000178935	ENSG00000269343	0	197	93.401	184	13	-2	-1	-2/-1
ENSG00000178935	ENSG00000204514	0	196	93.367	183	13	3	2	3/2
ENSG00000158158	ENSG00000148842	0	276	82.609	228	48	3	2	3/2
ENSG00000142207	ENSG00000170262	5.2e-138	203	100	203	0	-2	2	-2/2
ENSG00000142207	ENSG00000170262	1.15e-127	203	100	203	0	2	-1	2/-1
ENSG00000142207	ENSG00000170262	5.2e-138	203	100	203	0	-2	3	-2/3
ENSG00000142207	ENSG00000170262	1.15e-127	203	100	203	0	2	-1	2/-1
ENSG00000147123	ENSG00000182872	2.27e-124	174	100	174	0	1	-1	1/-1
ENSG00000147123	ENSG00000182872	8.25e-117	174	100	174	0	2	-2	2/-2
ENSG00000205863	ENSG00000240654	0	297	97.306	289	8	1	3	1/3
ENSG00000205863	ENSG00000240654	0	297	97.306	289	8	1	3	1/3
ENSG00000204390	ENSG00000204388	0	612	91.503	560	52	2	1	2/1
ENSG00000204390	ENSG00000204389	0	612	91.503	560	52	2	3	2/3
ENSG00000283374	ENSG00000206483	1.02e-143	207	100	207	0	1	2	1/2
ENSG00000283374	ENSG00000197763	1.25e-78	134	96.269	129	5	-1	-2	-1/-2
ENSG00000147206	ENSG00000269437	2.69e-96	147	82.993	122	25	-1	-3	-1/-3
ENSG00000147206	ENSG00000269437	2.11e-96	147	82.993	122	25	-1	-2	-1/-2
ENSG00000215126	ENSG00000196873	0	560	99.286	556	4	2	3	2/3
ENSG00000215126	ENSG00000147996	0	597	98.827	590	7	-2	-1	-2/-1
ENSG00000204231	ENSG00000186350	4.61e-131	117	91.453	107	10	1	2	1/2
ENSG00000241484	ENSG00000248405	0	269	100	269	0	1	3	1/3
ENSG00000255221	ENSG00000137752	3.05e-74	119	82.353	98	21	2	3	2/3
ENSG00000165572	ENSG00000120696	0	350	88.571	310	40	3	2	3/2
ENSG00000184908	ENSG00000186510	0	687	91.266	627	60	1	2	1/2
ENSG00000197620	ENSG00000197021	0	263	96.578	254	9	-1	-2	-1/-2
ENSG00000174130	ENSG00000174125	0	315	86.349	272	43	3	2	3/2
ENSG00000278224	ENSG00000124593	0	279	100	279	0	1	3	1/3
ENSG00000168970	ENSG00000243708	0	470	100	470	0	1	2	1/2
ENSG00000134873	ENSG00000134874	0	519	100	519	0	-2	3	-2/3
ENSG00000172785	ENSG00000136682	0	597	98.66	589	8	-2	-1	-2/-1
ENSG00000172785	ENSG00000196873	0	560	98.036	549	11	2	3	2/3
ENSG00000165443	ENSG00000148541	0	537	100	537	0	-3	1	-3/1
ENSG00000165443	ENSG00000148541	0	537	100	537	0	2	-2	2/-2
ENSG00000107485	ENSG00000179348	1.57e-115	118	94.068	111	7	2	1	2/1
ENSG00000205718	ENSG00000237247	3.09e-179	257	99.222	255	2	-3	-1	-3/-1
ENSG00000206527	ENSG00000105392	1.25e-52	101	84.158	85	16	2	3	2/3
ENSG00000216649	ENSG00000227488	1.86e-107	172	100	172	0	1	2	1/2
ENSG00000216649	ENSG00000237671	1.86e-107	172	100	172	0	1	2	1/2
ENSG00000111262	ENSG00000177301	0	156	91.026	142	14	1	2	1/2
ENSG00000204352	ENSG00000048828	2.42e-94	160	88.125	141	19	3	1	3/1
ENSG00000121281	ENSG00000166164	0	726	100	726	0	-2	1	-2/1
ENSG00000169621	ENSG00000169618	0	241	100	241	0	-2	-3	-2/-3
ENSG00000166200	ENSG00000146281	1.07e-85	132	82.576	109	23	3	1	3/1
ENSG00000072401	ENSG00000131508	1.83e-95	172	80.814	139	33	3	1	3/1
ENSG00000204152	ENSG00000265354	3.28e-142	225	96.889	218	7	1	3	1/3
ENSG00000188611	ENSG00000204147	0	741	98.516	730	11	-3	-2	-3/-2
ENSG00000134308	ENSG00000166913	7.36e-127	229	83.406	191	38	3	2	3/2
ENSG00000205922	ENSG00000169856	5e-94	155	88.387	137	18	1	3	1/3
ENSG00000205922	ENSG00000119547	5.31e-92	155	89.677	139	16	1	3	1/3
ENSG00000145945	ENSG00000071859	1.15e-139	148	85.811	127	21	1	3	1/3
ENSG00000212807	ENSG00000221970	0	311	100	311	0	1	2	1/2
ENSG00000148110	ENSG00000156875	0	374	84.225	315	59	3	2	3/2
ENSG00000204479	ENSG00000187545	0	489	86.912	425	64	-2	-3	-2/-3
ENSG00000213401	ENSG00000268606	0	415	84.578	351	64	-3	-1	-3/-1
ENSG00000188312	ENSG00000127080	0	446	100	446	0	3	-2	3/-2
ENSG00000147059	ENSG00000186787	0	383	95.039	364	19	1	2	1/2
ENSG00000152192	ENSG00000091010	1.32e-117	163	89.571	146	17	1	3	1/3
ENSG00000152192	ENSG00000151615	1.53e-102	158	93.038	147	11	1	3	1/3
ENSG00000137634	ENSG00000095110	6.38e-172	217	81.567	177	40	-2	-3	-2/-3
ENSG00000146038	ENSG00000146049	2.41e-123	199	99.497	198	1	2	-3	2/-3
ENSG00000135018	ENSG00000188021	0	163	90.184	147	16	3	2	3/2
ENSG00000159692	ENSG00000175029	0	309	88.997	275	34	2	3	2/3
ENSG00000170456	ENSG00000184014	0	101	82.178	83	18	2	1	2/1
ENSG00000212721	ENSG00000204880	0	145	93.103	135	10	-1	-3	-1/-3
ENSG00000212721	ENSG00000212722	2.23e-121	132	84.848	112	20	-1	-2	-1/-2
ENSG00000213214	ENSG00000050327	0	389	99.486	387	2	3	2	3/2
ENSG00000188312	ENSG00000127080	0	446	100	446	0	2	-2	2/-2
ENSG00000204779	ENSG00000184659	0	407	99.017	403	4	2	1	2/1
ENSG00000204779	ENSG00000187559	0	165	98.788	163	2	-2	-3	-2/-3
ENSG00000165059	ENSG00000072062	0	364	81.593	297	67	1	3	1/3
ENSG00000198176	ENSG00000114126	6.15e-119	100	86	86	14	3	1	3/1
ENSG00000106723	ENSG00000204271	4.05e-142	230	86.957	200	30	3	1	3/1
ENSG00000106723	ENSG00000204271	4.05e-142	230	86.957	200	30	3	1	3/1
ENSG00000071859	ENSG00000145945	1.38e-119	139	87.77	122	17	3	1	3/1
ENSG00000169955	ENSG00000261459	0	299	100	299	0	2	3	2/3
ENSG00000204147	ENSG00000188611	0	741	98.516	730	11	-2	-3	-2/-3
ENSG00000131737	ENSG00000006059	0	386	91.192	352	34	2	1	2/1
ENSG00000131737	ENSG00000094796	0	387	90.439	350	37	2	3	2/3
ENSG00000161010	ENSG00000161011	6.76e-145	207	100	207	0	3	-1	3/-1
ENSG00000161010	ENSG00000161011	1.01e-141	207	100	207	0	2	-3	2/-3
ENSG00000161010	ENSG00000161011	1.38e-121	207	100	207	0	-1	2	-1/2
ENSG00000005156	ENSG00000092871	0	867	100	867	0	1	-2	1/-2
ENSG00000005156	ENSG00000092871	0	867	100	867	0	-2	1	-2/1
ENSG00000183474	ENSG00000145736	0	392	99.49	390	2	-2	-3	-2/-3
ENSG00000043355	ENSG00000152977	7.71e-125	204	84.314	172	32	-1	-2	-1/-2
ENSG00000043355	ENSG00000156925	9.42e-136	168	89.881	151	17	3	2	3/2
ENSG00000165028	ENSG00000136783	0	309	87.055	269	40	3	1	3/1
ENSG00000073464	ENSG00000109572	0	536	80.224	430	106	2	3	2/3
ENSG00000090889	ENSG00000226650	0	698	89.828	627	71	1	3	1/3
ENSG00000137135	ENSG00000159884	2.09e-175	249	94.378	235	14	2	-3	2/-3
ENSG00000057608	ENSG00000203879	0	218	89.908	196	22	1	3	1/3
ENSG00000134551	ENSG00000231887	9.12e-72	110	94.545	104	6	1	2	1/2
ENSG00000186818	ENSG00000104972	0	176	82.955	146	30	1	3	1/3
ENSG00000135945	ENSG00000158417	3.55e-180	284	100	284	0	1	-1	1/-1
ENSG00000070476	ENSG00000198455	0	311	85.209	265	46	1	2	1/2
ENSG00000240871	ENSG00000204880	6.04e-87	127	80.315	102	25	-1	-2	-1/-2
ENSG00000121335	ENSG00000251655	1.09e-148	142	97.183	138	4	2	1	2/1
ENSG00000125835	ENSG00000128739	3.45e-93	100	97	97	3	2	3	2/3
ENSG00000147050	ENSG00000183878	0	408	88.725	362	46	3	1	3/1
ENSG00000161011	ENSG00000161010	2.23e-144	207	100	207	0	-1	3	-1/3
ENSG00000161011	ENSG00000161010	3.32e-141	207	100	207	0	-3	2	-3/2
ENSG00000147885	ENSG00000234829	6.91e-168	269	86.245	232	37	-3	-1	-3/-1
ENSG00000147885	ENSG00000186803	2.09e-154	261	87.356	228	33	1	2	1/2
ENSG00000168961	ENSG00000170298	0	261	90.421	236	25	1	2	1/2
ENSG00000120235	ENSG00000233816	4.66e-119	233	80.687	188	45	-3	-2	-3/-2
ENSG00000205497	ENSG00000205496	0	314	96.815	304	10	3	1	3/1
ENSG00000090061	ENSG00000205476	0	447	100	447	0	2	-3	2/-3
ENSG00000119715	ENSG00000196482	0	366	81.421	298	68	3	2	3/2
ENSG00000041988	ENSG00000007923	0	473	100	473	0	2	-1	2/-1
ENSG00000041988	ENSG00000007923	0	473	100	473	0	-1	3	-1/3
ENSG00000205029	ENSG00000186119	4.44e-160	304	81.25	247	57	1	3	1/3
ENSG00000147996	ENSG00000215126	0	207	98.068	203	4	1	2	1/2
ENSG00000184659	ENSG00000204779	0	407	99.017	403	4	1	2	1/2
ENSG00000184659	ENSG00000273514	0	236	98.305	232	4	1	3	1/3
ENSG00000240682	ENSG00000261796	8.79e-170	303	100	303	0	2	3	2/3
ENSG00000213139	ENSG00000113838	1.16e-65	103	100	103	0	-3	-1	-3/-1
ENSG00000213139	ENSG00000113838	7.22e-64	103	100	103	0	-1	-2	-1/-2
ENSG00000213139	ENSG00000113838	9.92e-64	103	100	103	0	-2	-3	-2/-3
ENSG00000163806	ENSG00000171103	4.16e-99	132	100	132	0	1	-2	1/-2
ENSG00000163806	ENSG00000171103	1.55e-95	132	100	132	0	-3	1	-3/1
ENSG00000205143	ENSG00000116017	3.02e-81	133	84.962	113	20	1	3	1/3
ENSG00000170122	ENSG00000184492	0	358	94.413	338	20	2	3	2/3
ENSG00000170122	ENSG00000187559	0	273	95.604	261	12	2	1	2/1
ENSG00000168255	ENSG00000267645	0	294	98.98	291	3	-3	-2	-3/-2
ENSG00000168255	ENSG00000267368	0	165	99.394	164	1	-1	-3	-1/-3
ENSG00000180138	ENSG00000113712	0	334	81.138	271	63	2	3	2/3
ENSG00000223609	ENSG00000244734	2.29e-87	161	85.093	137	24	-1	-3	-1/-3
ENSG00000243207	ENSG00000130810	0	312	100	312	0	1	2	1/2
ENSG00000205810	ENSG00000205809	3.07e-141	160	91.875	147	13	1	2	1/2
ENSG00000129873	ENSG00000182415	0	651	100	651	0	-2	-1	-2/-1
ENSG00000129873	ENSG00000172352	0	395	97.722	386	9	-2	-1	-2/-1
ENSG00000011052	ENSG00000243678	1.11e-138	210	96.667	203	7	3	1	3/1
ENSG00000212722	ENSG00000212721	2.61e-130	132	84.848	112	20	-2	-1	-2/-1
ENSG00000206047	ENSG00000240247	1.03e-68	121	100	121	0	2	3	2/3
ENSG00000165023	ENSG00000176490	4.64e-93	129	84.496	109	20	1	2	1/2
ENSG00000183049	ENSG00000134072	0	309	84.79	262	47	3	2	3/2
ENSG00000173575	ENSG00000153922	0	531	85.687	455	76	1	2	1/2
ENSG00000196368	ENSG00000122824	8.64e-139	180	93.333	168	12	-2	-3	-2/-3
ENSG00000196368	ENSG00000122824	2.41e-126	180	93.333	168	12	-2	-3	-2/-3
ENSG00000183753	ENSG00000185894	9.97e-69	107	100	107	0	-1	-2	-1/-2
ENSG00000183753	ENSG00000185894	2.59e-68	107	100	107	0	1	3	1/3
ENSG00000158373	ENSG00000180596	2.05e-65	118	92.373	109	9	1	2	1/2
ENSG00000205476	ENSG00000090061	0	447	100	447	0	-3	2	-3/2
ENSG00000132950	ENSG00000121741	1.44e-116	105	81.905	86	19	-2	-1	-2/-1
ENSG00000172780	ENSG00000261796	0	442	100	442	0	3	2	3/2
ENSG00000212122	ENSG00000100056	6.09e-154	277	82.31	228	49	1	-3	1/-3
ENSG00000212122	ENSG00000206203	6.1e-154	277	82.31	228	49	1	2	1/2
ENSG00000213886	ENSG00000204681	2.64e-164	246	98.374	242	4	2	3	2/3
ENSG00000205944	ENSG00000187191	0	501	96.008	481	20	1	2	1/2
ENSG00000241978	ENSG00000157654	0	907	100	907	0	1	3	1/3
ENSG00000101200	ENSG00000101405	2.95e-54	107	80.374	86	21	-1	-2	-1/-2
ENSG00000101350	ENSG00000084731	0	114	83.333	95	19	3	1	3/1
ENSG00000101350	ENSG00000084731	0	114	83.333	95	19	3	2	3/2
ENSG00000154529	ENSG00000106714	0	1216	98.273	1195	21	1	3	1/3
ENSG00000204248	ENSG00000130635	0	107	86.916	93	14	2	3	2/3
ENSG00000158639	ENSG00000238269	1.47e-78	135	87.407	118	17	-1	-3	-1/-3
ENSG00000206503	ENSG00000234745	0	312	86.859	271	41	1	3	1/3
ENSG00000096433	ENSG00000123104	0	146	84.932	124	22	2	1	2/1
ENSG00000206260	ENSG00000184814	2.94e-119	125	88.8	111	14	-1	-3	-1/-3
ENSG00000206260	ENSG00000233701	3.1900000000000002e-103	125	81.6	102	23	-1	-3	-1/-3
ENSG00000204612	ENSG00000171956	1.15e-83	116	90.517	105	11	1	3	1/3
