query	subject	evalue	alnlength	identity	identical	mismatches	qframe	sframe	bframe
ENSG00000001630	ENSG00000010404	2.46e-36	53	83.019	44	9	2	-3	2/-3
ENSG00000003509	ENSG00000197296	7.24e-43	96	81.25	78	18	-2	3	-2/3
ENSG00000004059	ENSG00000143761	5.5e-97	178	81.461	145	33	2	1	2/1
ENSG00000006116	ENSG00000166862	5.47e-132	175	84.571	148	27	3	2	3/2
ENSG00000005073	ENSG00000128713	3.68e-71	86	81.395	70	16	1	2	1/2
ENSG00000005073	ENSG00000123388	3.2e-61	83	83.133	69	14	1	3	1/3
ENSG00000004975	ENSG00000161202	0	131	91.603	120	11	2	3	2/3
ENSG00000004975	ENSG00000107404	0	131	81.679	107	24	2	1	2/1
ENSG00000007520	ENSG00000007516	2.64e-42	67	100	67	0	-1	1	-1/1
ENSG00000007520	ENSG00000007516	1.19e-36	67	100	67	0	2	-2	2/-2
ENSG00000006451	ENSG00000144118	1.07e-71	126	89.683	113	13	3	1	3/1
ENSG00000006451	ENSG00000144118	1.07e-71	126	89.683	113	13	3	2	3/2
ENSG00000010017	ENSG00000141084	2.65e-154	110	83.636	92	18	-2	-1	-2/-1
ENSG00000013588	ENSG00000175782	1.55e-64	53	81.132	43	10	-3	3	-3/3
ENSG00000006047	ENSG00000060138	1.93e-57	98	86.735	85	13	2	1	2/1
ENSG00000011478	ENSG00000138600	2.61e-83	106	81.132	86	20	2	3	2/3
ENSG00000006059	ENSG00000131738	0	386	93.264	360	26	1	3	1/3
ENSG00000006059	ENSG00000094796	0	373	93.834	350	23	1	3	1/3
ENSG00000015568	ENSG00000183054	0	946	100	946	0	-3	-2	-3/-2
ENSG00000015568	ENSG00000169629	0	946	99.683	943	3	-3	-2	-3/-2
ENSG00000050327	ENSG00000213214	0	389	99.486	387	2	2	3	2/3
ENSG00000037965	ENSG00000175879	6.45e-76	101	83.168	84	17	3	2	3/2
ENSG00000049245	ENSG00000139190	6.27e-37	75	88	66	9	2	1	2/1
ENSG00000049245	ENSG00000139190	6.27e-37	75	88	66	9	2	3	2/3
ENSG00000059804	ENSG00000173262	0	523	92.352	483	40	1	2	1/2
ENSG00000059804	ENSG00000173262	0	523	92.352	483	40	1	2	1/2
ENSG00000019549	ENSG00000124216	4.92e-73	113	85.841	97	16	3	2	3/2
ENSG00000048544	ENSG00000146966	4.54e-40	71	83.099	59	12	2	3	2/3
ENSG00000037757	ENSG00000132874	1.16e-47	95	87.368	83	12	-1	-3	-1/-3
ENSG00000088256	ENSG00000156052	0	360	90.278	325	35	3	2	3/2
ENSG00000088256	ENSG00000156049	0	356	81.742	291	65	3	2	3/2
ENSG00000170848	ENSG00000183668	0	446	90.135	402	44	1	2	1/2
ENSG00000081818	ENSG00000113205	3.37e-142	65	89.231	58	7	1	2	1/2
ENSG00000069943	ENSG00000260916	3.26e-73	125	98.4	123	2	-1	2	-1/2
ENSG00000069943	ENSG00000260916	3.26e-73	125	98.4	123	2	-1	1	-1/1
ENSG00000186847	ENSG00000128422	0	312	89.423	279	33	1	3	1/3
ENSG00000186847	ENSG00000186832	0	312	88.141	275	37	1	3	1/3
ENSG00000071655	ENSG00000267059	1.73e-115	182	100	182	0	-1	-3	-1/-3
ENSG00000127663	ENSG00000107077	0	357	80.952	289	68	3	1	3/1
ENSG00000112852	ENSG00000120327	0	124	95.161	118	6	-2	-1	-2/-1
ENSG00000112852	ENSG00000272674	0	124	89.516	111	13	-2	-1	-2/-1
ENSG00000077080	ENSG00000136518	0	363	87.328	317	46	3	1	3/1
ENSG00000077080	ENSG00000136518	0	363	87.328	317	46	3	1	3/1
ENSG00000078237	ENSG00000170088	1.93e-35	56	82.143	46	10	1	3	1/3
ENSG00000073598	ENSG00000073536	5.54e-140	151	99.338	150	1	2	-3	2/-3
ENSG00000068976	ENSG00000100994	0	833	84.154	701	132	1	3	1/3
ENSG00000068971	ENSG00000154001	0	283	81.625	231	52	2	3	2/3
ENSG00000068971	ENSG00000154001	0	283	81.625	231	52	2	1	2/1
ENSG00000087303	ENSG00000087302	0	236	98.729	233	3	3	-1	3/-1
ENSG00000100030	ENSG00000102882	0	346	88.15	305	41	1	2	1/2
ENSG00000083812	ENSG00000249471	0	516	90.891	469	47	2	3	2/3
ENSG00000099940	ENSG00000171208	5.68e-35	80	81.25	65	15	3	-3	3/-3
ENSG00000099940	ENSG00000231925	3.05e-35	77	81.818	63	14	3	-1	3/-1
ENSG00000100345	ENSG00000133026	0	700	83.286	583	117	1	2	1/2
ENSG00000099800	ENSG00000178297	1.83e-55	105	100	105	0	-2	2	-2/2
ENSG00000099995	ENSG00000187860	4.63e-26	51	100	51	0	2	-2	2/-2
ENSG00000099995	ENSG00000187860	4.63e-26	51	100	51	0	2	-2	2/-2
ENSG00000243811	ENSG00000128394	0	246	88.211	217	29	3	1	3/1
ENSG00000243811	ENSG00000244509	3.73e-152	119	82.353	98	21	2	1	2/1
ENSG00000100836	ENSG00000258643	7.71e-108	195	100	195	0	2	1	2/1
ENSG00000100836	ENSG00000258643	7.71e-108	195	100	195	0	2	1	2/1
ENSG00000100580	ENSG00000178665	3.16e-45	64	87.5	56	8	1	-1	1/-1
ENSG00000090581	ENSG00000059145	0	302	100	302	0	2	-2	2/-2
ENSG00000090581	ENSG00000059145	6.02e-178	302	100	302	0	3	-3	3/-3
ENSG00000023608	ENSG00000100784	2.08e-39	66	80.303	53	13	3	-1	3/-1
ENSG00000100314	ENSG00000100319	5.88e-83	139	97.122	135	4	-1	1	-1/1
ENSG00000099385	ENSG00000106635	3.15e-29	55	87.273	48	7	3	2	3/2
ENSG00000101210	ENSG00000156508	0	226	82.301	186	40	-2	-3	-2/-3
ENSG00000100554	ENSG00000134001	1.7e-51	84	100	84	0	1	-3	1/-3
ENSG00000100554	ENSG00000134001	9.01e-48	84	100	84	0	2	-1	2/-1
ENSG00000100554	ENSG00000134001	1.14e-46	84	100	84	0	-1	2	-1/2
ENSG00000101405	ENSG00000101200	2.33e-54	107	80.374	86	21	-2	-1	-2/-1
ENSG00000090470	ENSG00000161671	2.32e-46	70	88.571	62	8	-1	-2	-1/-2
ENSG00000090470	ENSG00000158270	2.11e-45	72	84.722	61	11	-1	-2	-1/-2
ENSG00000100412	ENSG00000100413	0	171	100	171	0	-2	2	-2/2
ENSG00000100412	ENSG00000100413	0	171	100	171	0	-2	3	-2/3
ENSG00000187758	ENSG00000248144	0	494	90.486	447	47	1	2	1/2
ENSG00000187758	ENSG00000196616	0	446	90.583	404	42	1	3	1/3
ENSG00000086232	ENSG00000106305	7.52e-106	178	100	178	0	2	-1	2/-1
ENSG00000185019	ENSG00000265491	1.13e-75	79	81.013	64	15	-2	3	-2/3
ENSG00000089723	ENSG00000089737	1.24e-149	213	100	213	0	-2	3	-2/3
ENSG00000089723	ENSG00000089737	4.07e-132	213	100	213	0	1	-1	1/-1
ENSG00000095917	ENSG00000172236	0	282	85.106	240	42	2	1	2/1
ENSG00000183741	ENSG00000141570	2.85e-40	79	86.076	68	11	3	2	3/2
ENSG00000099974	ENSG00000099977	4.27e-61	104	96.154	100	4	-3	-2	-3/-2
ENSG00000099974	ENSG00000099977	4.27e-61	104	96.154	100	4	-3	-2	-3/-2
ENSG00000100485	ENSG00000115904	0	181	80.11	145	36	3	1	3/1
ENSG00000100028	ENSG00000138867	9.27e-69	107	100	107	0	2	-3	2/-3
ENSG00000100028	ENSG00000138867	7.91e-63	107	100	107	0	1	-2	1/-2
ENSG00000101292	ENSG00000169618	1.1e-152	241	84.232	203	38	-2	-3	-2/-3
ENSG00000185339	ENSG00000100029	5.28e-53	82	100	82	0	1	-1	1/-1
ENSG00000100504	ENSG00000100994	0	697	80.775	563	134	1	3	1/3
ENSG00000087510	ENSG00000008196	1.27e-116	126	85.714	108	18	1	2	1/2
ENSG00000087510	ENSG00000137203	1.09e-107	144	80.556	116	28	1	3	1/3
ENSG00000101162	ENSG00000124172	0	395	100	395	0	-3	2	-3/2
ENSG00000101162	ENSG00000137285	0	433	80.6	349	84	3	1	3/1
ENSG00000099804	ENSG00000107341	8.22e-122	198	86.869	172	26	2	3	2/3
ENSG00000086548	ENSG00000105388	3.76e-175	159	83.648	133	26	-3	-2	-3/-2
ENSG00000086548	ENSG00000105388	4.44e-175	159	83.648	133	26	-3	-2	-3/-2
ENSG00000100528	ENSG00000143786	3.92e-49	51	82.353	42	9	3	1	3/1
ENSG00000100450	ENSG00000100453	4.38e-108	129	86.047	111	18	1	3	1/3
ENSG00000092607	ENSG00000112837	7.75e-157	234	85.47	200	34	1	3	1/3
ENSG00000100490	ENSG00000125375	2.67e-175	258	99.225	256	2	1	-2	1/-2
ENSG00000100994	ENSG00000068976	0	697	83.07	579	118	3	1	3/1
ENSG00000084444	ENSG00000111696	1.22e-50	53	83.019	44	9	3	1	3/1
ENSG00000100453	ENSG00000100450	7.72e-110	152	84.211	128	24	3	1	3/1
ENSG00000083720	ENSG00000198754	0	221	80.543	178	43	3	1	3/1
ENSG00000100564	ENSG00000054690	3.88e-65	100	100	100	0	2	-3	2/-3
ENSG00000100564	ENSG00000054690	1.5e-61	100	100	100	0	3	-1	3/-1
ENSG00000100564	ENSG00000054690	2.06e-61	100	100	100	0	-1	3	-1/3
ENSG00000100564	ENSG00000054690	1.01e-60	100	100	100	0	-2	1	-2/1
ENSG00000100564	ENSG00000054690	3.59e-60	100	100	100	0	1	-2	1/-2
ENSG00000100564	ENSG00000054690	9.3e-56	100	100	100	0	-3	2	-3/2
ENSG00000090060	ENSG00000218823	0	527	82.922	437	90	-2	-3	-2/-3
ENSG00000094804	ENSG00000110723	1.64e-34	68	83.824	57	11	-3	-1	-3/-1
ENSG00000101138	ENSG00000183762	1.58e-69	57	80.702	46	11	-1	1	-1/1
ENSG00000088356	ENSG00000131044	2.98e-133	207	100	207	0	-1	1	-1/1
ENSG00000100104	ENSG00000100109	0	338	91.124	308	30	-1	2	-1/2
ENSG00000100104	ENSG00000100109	0	338	91.124	308	30	-1	3	-1/3
ENSG00000100221	ENSG00000142065	1.21e-40	70	81.429	57	13	-3	2	-3/2
ENSG00000100221	ENSG00000101966	8.5e-47	71	84.507	60	11	3	-1	3/-1
ENSG00000197208	ENSG00000197375	0	322	86.025	277	45	1	3	1/3
ENSG00000108773	ENSG00000114166	0	239	83.682	200	39	1	3	1/3
ENSG00000060138	ENSG00000065978	7.86e-56	91	94.505	86	5	1	2	1/2
ENSG00000103021	ENSG00000103023	1.22e-173	254	100	254	0	3	-2	3/-2
ENSG00000105617	ENSG00000088038	3.83e-75	68	100	68	0	-3	3	-3/3
ENSG00000091651	ENSG00000178202	4.9e-38	91	80.22	73	18	1	3	1/3
ENSG00000091651	ENSG00000156162	2.93e-48	80	82.5	66	14	-2	1	-2/1
ENSG00000039123	ENSG00000067113	1.23e-100	160	100	160	0	1	-2	1/-2
ENSG00000039123	ENSG00000067113	6.0100000000000005e-100	160	100	160	0	-2	2	-2/2
ENSG00000039123	ENSG00000067113	5.55e-99	160	100	160	0	-3	3	-3/3
ENSG00000111664	ENSG00000078369	0	341	83.284	284	57	1	3	1/3
ENSG00000111664	ENSG00000078369	0	341	83.284	284	57	1	3	1/3
ENSG00000111704	ENSG00000138592	0	61	88.525	54	7	2	-1	2/-1
ENSG00000114450	ENSG00000078369	3.51e-125	77	80.519	62	15	-2	-1	-2/-1
ENSG00000105258	ENSG00000105254	1.7e-77	120	100	120	0	-1	1	-1/1
ENSG00000105258	ENSG00000105254	7.7e-76	120	100	120	0	2	-1	2/-1
ENSG00000105971	ENSG00000129480	3.42e-40	86	80.233	69	17	1	-2	1/-2
ENSG00000105254	ENSG00000105258	3.44e-79	120	100	120	0	2	-2	2/-2
ENSG00000105254	ENSG00000105258	2.94e-77	120	100	120	0	1	-1	1/-1
ENSG00000105254	ENSG00000105258	1.33e-75	120	100	120	0	-1	2	-1/2
ENSG00000114388	ENSG00000114395	2.14e-59	99	97.98	97	2	3	-1	3/-1
ENSG00000114784	ENSG00000173812	1.19e-59	116	92.241	107	9	1	3	1/3
ENSG00000104848	ENSG00000111262	1.66e-145	149	85.235	127	22	3	1	3/1
ENSG00000109061	ENSG00000264424	0	630	95.873	604	26	3	1	3/1
ENSG00000105352	ENSG00000170956	9.42e-132	68	82.353	56	12	1	2	1/2
ENSG00000109684	ENSG00000005156	1.21e-36	84	90.476	76	8	3	-3	3/-3
ENSG00000109684	ENSG00000092871	1.21e-36	84	90.476	76	8	3	2	3/2
ENSG00000105649	ENSG00000152932	1.68e-123	194	88.66	172	22	3	2	3/2
ENSG00000105649	ENSG00000169213	9.63e-114	196	82.653	162	34	3	1	3/1
ENSG00000065057	ENSG00000103197	1.09e-17	52	100	52	0	-1	2	-1/2
ENSG00000103966	ENSG00000110047	3.52e-121	52	86.538	45	7	-1	-3	-1/-3
ENSG00000103966	ENSG00000110047	5.27e-121	52	86.538	45	7	-1	-2	-1/-2
ENSG00000104695	ENSG00000113575	0	310	97.419	302	8	2	3	2/3
ENSG00000108417	ENSG00000171360	0	252	87.302	220	32	-1	-2	-1/-2
ENSG00000004468	ENSG00000144161	1.45e-49	72	81.944	59	13	-1	1	-1/1
ENSG00000108829	ENSG00000154920	1.47e-51	81	100	81	0	3	-3	3/-3
ENSG00000108829	ENSG00000154920	1.86e-50	81	100	81	0	-2	1	-2/1
ENSG00000113211	ENSG00000113209	0	299	83.612	250	49	-2	-1	-2/-1
ENSG00000109943	ENSG00000130368	1.14e-38	97	80.412	78	19	-1	-3	-1/-3
ENSG00000114853	ENSG00000198740	0	260	91.538	238	22	3	2	3/2
ENSG00000114853	ENSG00000198740	0	260	91.538	238	22	3	2	3/2
ENSG00000197417	ENSG00000262304	0	844	100	844	0	2	1	2/1
ENSG00000108468	ENSG00000122565	1.3e-59	67	86.567	58	9	1	3	1/3
ENSG00000111245	ENSG00000106436	5.44e-80	137	81.752	112	25	1	2	1/2
ENSG00000111786	ENSG00000257218	3.17e-64	102	100	102	0	2	-1	2/-1
ENSG00000111786	ENSG00000136450	1.41e-74	74	82.432	61	13	2	3	2/3
ENSG00000104964	ENSG00000106829	7.26e-57	108	84.259	91	17	1	3	1/3
ENSG00000125149	ENSG00000237172	2.51e-102	145	100	145	0	1	-1	1/-1
ENSG00000125149	ENSG00000237172	7.62e-100	145	100	145	0	-1	2	-1/2
ENSG00000108590	ENSG00000129235	0	408	100	408	0	3	-2	3/-2
ENSG00000111339	ENSG00000141759	3.52e-44	73	83.562	61	12	-3	-2	-3/-2
ENSG00000111339	ENSG00000063245	4.77e-44	75	85.333	64	11	-3	-1	-3/-1
ENSG00000102218	ENSG00000174840	1.2e-45	98	80.612	79	19	-3	-1	-3/-1
ENSG00000102218	ENSG00000174840	1.2e-45	98	80.612	79	19	-3	-1	-3/-1
ENSG00000104164	ENSG00000063245	1.63e-42	66	81.818	54	12	-3	3	-3/3
ENSG00000107018	ENSG00000107014	5.52e-139	260	83.462	217	43	-3	-2	-3/-2
ENSG00000105392	ENSG00000160194	2.49e-117	59	83.051	49	10	1	-3	1/-3
ENSG00000109917	ENSG00000196236	5.11e-83	51	80.392	41	10	-2	-1	-2/-1
ENSG00000104897	ENSG00000104886	4.49e-67	99	96.97	96	3	-2	2	-2/2
ENSG00000106588	ENSG00000256646	6.04e-162	261	99.617	260	1	-2	-1	-2/-1
ENSG00000108684	ENSG00000110881	0	160	85	136	24	1	2	1/2
ENSG00000105516	ENSG00000063176	1.52e-87	125	100	125	0	2	-1	2/-1
ENSG00000105516	ENSG00000063176	2.44e-81	125	100	125	0	-1	1	-1/1
ENSG00000105516	ENSG00000063176	2.64e-70	125	100	125	0	-2	2	-2/2
ENSG00000105516	ENSG00000063176	2.09e-55	125	100	125	0	3	-2	3/-2
ENSG00000105516	ENSG00000063176	2.44e-81	125	100	125	0	-1	1	-1/1
ENSG00000105516	ENSG00000063176	2.64e-70	125	100	125	0	-2	2	-2/2
ENSG00000105516	ENSG00000063176	2.09e-55	125	100	125	0	3	-1	3/-1
ENSG00000111615	ENSG00000139278	0	379	99.736	378	1	-2	2	-2/2
ENSG00000113205	ENSG00000272674	0	130	87.692	114	16	-2	-1	-2/-1
ENSG00000113205	ENSG00000113248	0	73	83.562	61	12	1	3	1/3
ENSG00000113722	ENSG00000165556	2.31e-37	64	93.75	60	4	2	1	2/1
ENSG00000113722	ENSG00000131264	1.22e-32	63	88.889	56	7	2	1	2/1
ENSG00000112855	ENSG00000170445	3.47e-64	117	96.581	113	4	2	-1	2/-1
ENSG00000105072	ENSG00000085872	7.61e-37	53	94.34	50	3	3	-1	3/-1
ENSG00000078967	ENSG00000131508	5.68e-96	149	92.617	138	11	3	1	3/1
ENSG00000111911	ENSG00000141759	5.67e-47	54	87.037	47	7	-3	-2	-3/-2
ENSG00000111911	ENSG00000141759	1.64e-44	54	87.037	47	7	2	1	2/1
ENSG00000106004	ENSG00000120075	3.49e-78	80	93.75	75	5	2	1	2/1
ENSG00000106004	ENSG00000172789	2.9e-41	65	87.692	57	8	2	1	2/1
ENSG00000186115	ENSG00000186529	0	694	93.372	648	46	1	2	1/2
ENSG00000186115	ENSG00000186529	0	694	93.372	648	46	1	3	1/3
ENSG00000005381	ENSG00000121053	3.84e-124	65	81.538	53	12	2	1	2/1
ENSG00000106258	ENSG00000160868	0	442	83.032	367	75	-2	-3	-2/-3
ENSG00000106258	ENSG00000282301	0	422	81.754	345	77	2	1	2/1
ENSG00000105953	ENSG00000197444	0	706	83.711	591	115	1	3	1/3
ENSG00000105664	ENSG00000113296	0	271	87.823	238	33	1	2	1/2
ENSG00000105664	ENSG00000113296	0	271	87.823	238	33	1	2	1/2
ENSG00000103064	ENSG00000103061	0	977	100	977	0	-3	2	-3/2
ENSG00000088038	ENSG00000105617	1.05e-74	68	100	68	0	3	-3	3/-3
ENSG00000109079	ENSG00000110906	3.39e-54	55	81.818	45	10	-2	-1	-2/-1
ENSG00000109079	ENSG00000174943	3.53e-62	55	87.273	48	7	-2	-1	-2/-1
ENSG00000016082	ENSG00000159556	0	188	81.383	153	35	3	2	3/2
ENSG00000101842	ENSG00000114999	1.3e-72	87	82.759	72	15	1	-2	1/-2
ENSG00000111981	ENSG00000131019	1.48e-77	85	89.412	76	9	2	3	2/3
ENSG00000114349	ENSG00000134183	0	326	83.129	271	55	1	2	1/2
ENSG00000104835	ENSG00000128626	4.58e-74	116	100	116	0	2	-2	2/-2
ENSG00000104835	ENSG00000128626	6.29e-74	116	100	116	0	-2	1	-2/1
ENSG00000113212	ENSG00000120324	0	106	90.566	96	10	-3	-1	-3/-1
ENSG00000113212	ENSG00000177839	6.61e-151	65	87.692	57	8	3	2	3/2
ENSG00000112309	ENSG00000112305	0	519	100	519	0	3	-1	3/-1
ENSG00000112309	ENSG00000112305	0	519	100	519	0	3	-2	3/-2
ENSG00000109208	ENSG00000171201	9.67e-97	59	94.915	56	3	-3	-2	-3/-2
ENSG00000109208	ENSG00000171201	3.77e-89	59	94.915	56	3	2	1	2/1
ENSG00000109208	ENSG00000171201	9.67e-97	59	94.915	56	3	-3	-1	-3/-1
ENSG00000109208	ENSG00000171201	3.77e-89	59	94.915	56	3	2	1	2/1
ENSG00000105793	ENSG00000175782	2.11e-72	57	84.211	48	9	-1	3	-1/3
ENSG00000103056	ENSG00000132600	5.75e-44	76	100	76	0	2	-1	2/-1
ENSG00000103056	ENSG00000132600	2.22e-32	76	100	76	0	-2	3	-2/3
ENSG00000103707	ENSG00000094916	1.44e-106	52	80.769	42	10	2	3	2/3
ENSG00000103707	ENSG00000094916	1.19e-80	52	80.769	42	10	3	1	3/1
ENSG00000103460	ENSG00000198846	9.07e-46	86	82.558	71	15	1	3	1/3
ENSG00000110975	ENSG00000134207	4.94e-179	74	83.784	62	12	1	2	1/2
ENSG00000110975	ENSG00000134207	6.77e-179	74	83.784	62	12	1	2	1/2
ENSG00000104863	ENSG00000148943	2.56e-101	204	82.353	168	36	3	1	3/1
ENSG00000103121	ENSG00000136213	7.16e-132	101	84.158	85	16	-3	-2	-3/-2
ENSG00000108759	ENSG00000197079	1.25e-179	329	80.851	266	63	3	2	3/2
ENSG00000123908	ENSG00000092847	0	838	83.652	701	137	3	1	3/1
ENSG00000113851	ENSG00000072756	1.18e-72	116	98.276	114	2	2	-3	2/-3
ENSG00000107796	ENSG00000159251	0	388	96.907	376	12	1	3	1/3
ENSG00000107796	ENSG00000163017	0	376	98.936	372	4	1	2	1/2
ENSG00000106305	ENSG00000086232	1.88e-106	178	100	178	0	-1	2	-1/2
ENSG00000109132	ENSG00000165462	1.75e-55	92	82.609	76	16	1	2	1/2
ENSG00000102962	ENSG00000175782	1.51e-66	60	80	48	12	3	-2	3/-2
ENSG00000102962	ENSG00000160991	1.39e-60	55	80	44	11	1	-3	1/-3
ENSG00000064199	ENSG00000110013	9.03e-27	52	96.154	50	2	2	-2	2/-2
ENSG00000109084	ENSG00000109083	1.5e-73	120	100	120	0	3	-1	3/-1
ENSG00000109084	ENSG00000109083	5.35e-69	120	100	120	0	-1	3	-1/3
ENSG00000109084	ENSG00000109083	7.35e-65	120	100	120	0	-2	1	-2/1
ENSG00000105647	ENSG00000268173	0	402	100	402	0	1	3	1/3
ENSG00000114904	ENSG00000114902	0	898	100	898	0	-3	2	-3/2
ENSG00000104129	ENSG00000137880	9.5e-128	161	100	161	0	-2	2	-2/2
ENSG00000104129	ENSG00000137880	1.24e-121	161	100	161	0	3	-1	3/-1
ENSG00000104129	ENSG00000137880	2.08e-116	161	100	161	0	-1	1	-1/1
ENSG00000104826	ENSG00000213030	1.95e-72	123	86.179	106	17	-1	-2	-1/-2
ENSG00000104826	ENSG00000104827	1.76e-71	123	86.179	106	17	-1	-2	-1/-2
ENSG00000102128	ENSG00000172476	0	254	98.031	249	5	3	2	3/2
ENSG00000102128	ENSG00000172476	0	254	98.031	249	5	3	1	3/1
ENSG00000108379	ENSG00000154342	0	347	85.014	295	52	2	1	2/1
ENSG00000106089	ENSG00000099365	7.14e-137	257	85.214	219	38	1	2	1/2
ENSG00000109272	ENSG00000163737	2.29e-47	102	87.255	89	13	-2	-3	-2/-3
ENSG00000104888	ENSG00000091664	0	512	82.422	422	90	2	3	2/3
ENSG00000104888	ENSG00000179520	0	178	84.831	151	27	2	1	2/1
ENSG00000175106	ENSG00000259024	3.3e-118	186	100	186	0	1	3	1/3
ENSG00000113248	ENSG00000113205	0	158	89.241	141	17	1	2	1/2
ENSG00000113248	ENSG00000272674	1.76e-172	160	85	136	24	1	2	1/2
ENSG00000106080	ENSG00000175782	3.66e-104	81	83.951	68	13	-2	-1	-2/-1
ENSG00000106080	ENSG00000163683	2.93e-113	50	80	40	10	-3	-2	-3/-2
ENSG00000108179	ENSG00000196262	1.16e-82	145	80	116	29	3	1	3/1
ENSG00000109107	ENSG00000149925	0	366	81.967	300	66	3	1	3/1
ENSG00000106245	ENSG00000106246	1.36e-70	73	100	73	0	-1	1	-1/1
ENSG00000106245	ENSG00000106246	1.55e-68	73	100	73	0	-2	2	-2/2
ENSG00000104221	ENSG00000020181	3.1e-158	236	100	236	0	-1	2	-1/2
ENSG00000104221	ENSG00000020181	1.4e-156	236	100	236	0	-2	3	-2/3
ENSG00000104221	ENSG00000020181	1.64e-150	236	100	236	0	3	-2	3/-2
ENSG00000102057	ENSG00000171385	0	241	84.232	203	38	3	2	3/2
ENSG00000102057	ENSG00000171385	0	241	84.232	203	38	3	1	3/1
ENSG00000123569	ENSG00000101812	7.6e-79	64	81.25	52	12	3	1	3/1
ENSG00000113209	ENSG00000113211	0	104	91.346	95	9	-3	-1	-3/-1
ENSG00000111725	ENSG00000131791	1.37e-107	95	88.421	84	11	1	2	1/2
ENSG00000111639	ENSG00000010292	6.78e-42	73	100	73	0	-1	1	-1/1
ENSG00000111639	ENSG00000010292	3.32e-41	73	100	73	0	2	-2	2/-2
ENSG00000091010	ENSG00000152192	2.8e-119	165	89.091	147	18	3	1	3/1
ENSG00000132275	ENSG00000175782	3.03e-28	62	80.645	50	12	2	-2	2/-2
ENSG00000115282	ENSG00000175575	1.4e-25	55	85.455	47	8	2	1	2/1
ENSG00000115282	ENSG00000229676	2.26e-27	56	87.5	49	7	2	1	2/1
ENSG00000131738	ENSG00000006059	0	386	93.264	360	26	3	1	3/1
ENSG00000131738	ENSG00000094796	0	183	93.443	171	12	-2	-3	-2/-3
ENSG00000105705	ENSG00000129933	4.67e-32	54	100	54	0	-2	2	-2/2
ENSG00000105705	ENSG00000129933	5.47e-30	54	100	54	0	3	-3	3/-3
ENSG00000226941	ENSG00000169800	0	415	100	415	0	1	2	1/2
ENSG00000226941	ENSG00000234414	0	415	99.277	412	3	1	3	1/3
ENSG00000122543	ENSG00000135175	2.3e-153	231	98.268	227	4	-3	-1	-3/-1
ENSG00000133028	ENSG00000072958	7.28e-173	56	82.143	46	10	3	-1	3/-1
ENSG00000133028	ENSG00000198393	1.28e-123	51	82.353	42	9	1	2	1/2
ENSG00000105821	ENSG00000105819	3.71e-69	57	100	57	0	-3	3	-3/3
ENSG00000105821	ENSG00000105819	1.7e-64	57	100	57	0	2	-1	2/-1
ENSG00000134001	ENSG00000100554	4.34e-51	84	100	84	0	-3	1	-3/1
ENSG00000134001	ENSG00000100554	7.57e-50	84	100	84	0	1	-3	1/-3
ENSG00000134001	ENSG00000100554	2.3e-47	84	100	84	0	-1	2	-1/2
ENSG00000134001	ENSG00000100554	2.92e-46	84	100	84	0	2	-1	2/-1
ENSG00000129824	ENSG00000280969	4.44e-172	264	93.939	248	16	2	1	2/1
ENSG00000129824	ENSG00000198034	1.15e-171	265	92.83	246	19	2	1	2/1
ENSG00000028839	ENSG00000146411	0	463	100	463	0	1	-2	1/-2
ENSG00000131097	ENSG00000108883	2.62e-28	50	100	50	0	2	-1	2/-1
ENSG00000131097	ENSG00000108883	8.62e-27	50	100	50	0	-1	3	-1/3
ENSG00000131097	ENSG00000108883	5.79e-26	50	100	50	0	3	-2	3/-2
ENSG00000131097	ENSG00000108883	4.94e-24	50	100	50	0	-2	1	-2/1
ENSG00000126602	ENSG00000213918	1.01e-141	68	97.059	66	2	3	-1	3/-1
ENSG00000127528	ENSG00000136826	3.24e-71	103	94.175	97	6	3	1	3/1
ENSG00000126261	ENSG00000215193	7.19e-29	61	80.328	49	12	2	-1	2/-1
ENSG00000256683	ENSG00000176024	0	64	85.938	55	9	1	3	1/3
ENSG00000123584	ENSG00000267978	0	460	99.565	458	2	2	1	2/1
ENSG00000133275	ENSG00000151292	0	247	93.927	232	15	2	1	2/1
ENSG00000121297	ENSG00000179981	0	148	85.135	126	22	2	1	2/1
ENSG00000121297	ENSG00000179981	0	148	85.135	126	22	2	3	2/3
ENSG00000118160	ENSG00000100678	0	205	84.878	174	31	1	3	1/3
ENSG00000118160	ENSG00000100678	0	205	84.878	174	31	1	3	1/3
ENSG00000170454	ENSG00000186081	0	355	87.042	309	46	3	2	3/2
ENSG00000170454	ENSG00000205420	0	355	84.507	300	55	3	1	3/1
ENSG00000116205	ENSG00000160991	1.36e-62	53	81.132	43	10	2	-3	2/-3
ENSG00000116205	ENSG00000160991	1.48e-62	53	81.132	43	10	2	-3	2/-3
ENSG00000134061	ENSG00000167693	6.65e-42	96	81.25	78	18	-3	-2	-3/-2
ENSG00000134061	ENSG00000167693	6.65e-42	96	81.25	78	18	-3	-2	-3/-2
ENSG00000171360	ENSG00000108417	2.17e-169	159	90.566	144	15	-2	-1	-2/-1
ENSG00000129235	ENSG00000108590	0	408	100	408	0	2	-3	2/-3
ENSG00000129235	ENSG00000108590	0	408	100	408	0	-2	3	-2/3
ENSG00000129235	ENSG00000198920	1.77e-33	56	100	56	0	-2	2	-2/2
ENSG00000129235	ENSG00000198920	3.92e-31	56	100	56	0	3	-3	3/-3
ENSG00000129235	ENSG00000198920	1.77e-29	56	100	56	0	-1	1	-1/1
ENSG00000129235	ENSG00000198920	6.32e-29	56	100	56	0	1	-1	1/-1
ENSG00000129235	ENSG00000198920	8.69e-21	56	100	56	0	2	-2	2/-2
ENSG00000115541	ENSG00000270757	1.65e-36	65	98.462	64	1	1	2	1/2
ENSG00000114999	ENSG00000198393	3.23e-123	77	83.117	64	13	2	1	2/1
ENSG00000130383	ENSG00000171124	0	316	91.772	290	26	2	3	2/3
ENSG00000121068	ENSG00000135111	4.79e-169	239	87.448	209	30	3	2	3/2
ENSG00000118804	ENSG00000272414	0	643	100	643	0	-3	-1	-3/-1
ENSG00000115825	ENSG00000184304	0	329	90.578	298	31	1	2	1/2
ENSG00000105447	ENSG00000182324	3.95e-63	116	100	116	0	2	1	2/1
ENSG00000127311	ENSG00000169609	1.98e-155	94	81.915	77	17	3	-1	3/-1
ENSG00000120075	ENSG00000106004	2.33e-68	80	93.75	75	5	1	2	1/2
ENSG00000124140	ENSG00000113504	0	256	89.453	229	27	2	3	2/3
ENSG00000111364	ENSG00000111361	2.37e-102	104	100	104	0	-2	2	-2/2
ENSG00000111364	ENSG00000111361	6.44e-99	104	100	104	0	-3	3	-3/3
ENSG00000111364	ENSG00000111361	1.11e-97	104	100	104	0	2	-2	2/-2
ENSG00000130810	ENSG00000243207	0	337	100	337	0	-1	-3	-1/-3
ENSG00000182521	ENSG00000112592	1.85e-115	195	90.256	176	19	3	1	3/1
ENSG00000126778	ENSG00000170577	1.6e-128	188	95.213	179	9	1	3	1/3
ENSG00000131381	ENSG00000177225	5.16e-67	57	80.702	46	11	3	-2	3/-2
ENSG00000120149	ENSG00000141194	0	193	89.119	172	21	3	2	3/2
ENSG00000120149	ENSG00000163132	1.46e-68	109	80.734	88	21	2	1	2/1
ENSG00000254245	ENSG00000081853	0	412	100	412	0	3	2	3/2
ENSG00000119820	ENSG00000215193	0	100	85	85	15	3	-2	3/-2
ENSG00000119820	ENSG00000134830	0	97	80.412	78	19	-2	2	-2/2
ENSG00000132842	ENSG00000103723	0	240	82.083	197	43	3	2	3/2
ENSG00000125629	ENSG00000186480	3.09e-110	185	84.324	156	29	3	2	3/2
ENSG00000131966	ENSG00000273274	3.38e-42	60	83.333	50	10	-3	-2	-3/-2
ENSG00000131966	ENSG00000171109	8.77e-42	60	83.333	50	10	-3	-1	-3/-1
ENSG00000131966	ENSG00000171109	1.68e-31	60	83.333	50	10	2	1	2/1
ENSG00000120324	ENSG00000177839	0	672	92.411	621	51	3	1	3/1
ENSG00000120324	ENSG00000113212	0	101	90.099	91	10	-1	-3	-1/-3
ENSG00000111801	ENSG00000026950	0	422	81.043	342	80	3	2	3/2
ENSG00000092345	ENSG00000205944	0	189	83.069	157	32	2	1	2/1
ENSG00000122068	ENSG00000175782	1.2e-78	91	80.22	73	18	-1	3	-1/3
ENSG00000128276	ENSG00000128253	0	375	94.133	353	22	-1	-3	-1/-3
ENSG00000131462	ENSG00000037042	0	454	97.577	443	11	3	2	3/2
ENSG00000126368	ENSG00000126351	9.37e-43	102	89.216	91	11	2	-1	2/-1
ENSG00000134489	ENSG00000066427	4.28e-59	65	80	52	13	2	-2	2/-2
ENSG00000124469	ENSG00000079385	1.39e-103	174	81.034	141	33	-1	-2	-1/-2
ENSG00000124469	ENSG00000079385	4.45e-102	174	81.034	141	33	-1	-3	-1/-3
ENSG00000124575	ENSG00000168298	3.05e-31	73	100	73	0	1	2	1/2
ENSG00000134287	ENSG00000143761	1.6e-114	177	97.175	172	5	3	1	3/1
ENSG00000204604	ENSG00000198538	0	172	89.535	154	18	2	3	2/3
ENSG00000120952	ENSG00000116721	0	547	94.333	516	31	1	2	1/2
ENSG00000120952	ENSG00000204481	0	547	92.505	506	41	1	2	1/2
ENSG00000131094	ENSG00000165985	4.67e-87	133	87.218	116	17	3	2	3/2
ENSG00000131094	ENSG00000186897	7.33e-87	134	88.06	118	16	3	1	3/1
ENSG00000048392	ENSG00000171848	4.3e-175	154	86.364	133	21	2	1	2/1
ENSG00000138286	ENSG00000213551	7.6e-176	232	100	232	0	1	-3	1/-3
ENSG00000138286	ENSG00000213551	6.37e-159	232	100	232	0	3	-2	3/-2
ENSG00000138286	ENSG00000213551	2.62e-156	232	100	232	0	-3	1	-3/1
ENSG00000130489	ENSG00000284194	3.54e-180	192	100	192	0	3	1	3/1
ENSG00000112379	ENSG00000196689	2.7e-55	82	80.488	66	16	1	-3	1/-3
ENSG00000130538	ENSG00000258453	0	327	98.777	323	4	1	3	1/3
ENSG00000130538	ENSG00000257115	0	327	98.777	323	4	1	3	1/3
ENSG00000130538	ENSG00000257115	0	327	98.777	323	4	2	1	2/1
ENSG00000130538	ENSG00000257115	0	327	98.777	323	4	-2	-1	-2/-1
ENSG00000134201	ENSG00000134184	8.82e-131	238	80.672	192	46	1	3	1/3
ENSG00000134201	ENSG00000168765	8.13e-112	143	83.217	119	24	-1	-3	-1/-3
ENSG00000129514	ENSG00000125798	6.21e-85	109	89.908	98	11	-3	-1	-3/-1
ENSG00000129514	ENSG00000125798	1.32e-83	109	89.908	98	11	-3	-1	-3/-1
ENSG00000132475	ENSG00000188375	0	129	96.899	125	4	2	1	2/1
ENSG00000114547	ENSG00000065371	0	293	95.904	281	12	2	1	2/1
ENSG00000120068	ENSG00000037965	1.35e-76	64	93.75	60	4	2	3	2/3
ENSG00000120068	ENSG00000175879	1.36e-56	88	90.909	80	8	2	1	2/1
ENSG00000173473	ENSG00000139613	0	129	86.047	111	18	1	2	1/2
ENSG00000120327	ENSG00000112852	0	110	83.636	92	18	-2	-3	-2/-3
ENSG00000120327	ENSG00000272674	0	65	93.846	61	4	3	2	3/2
ENSG00000132286	ENSG00000283977	1.12e-64	132	100	132	0	-3	-2	-3/-2
ENSG00000120322	ENSG00000272674	0	473	84.144	398	75	3	1	3/1
ENSG00000120322	ENSG00000187372	0	421	93.587	394	27	2	1	2/1
ENSG00000130733	ENSG00000142453	1.09e-136	245	100	245	0	2	-1	2/-1
ENSG00000214042	ENSG00000236637	8.82e-153	245	91.02	223	22	1	2	1/2
ENSG00000123353	ENSG00000135392	0	306	100	306	0	1	-1	1/-1
ENSG00000123353	ENSG00000135392	0	306	100	306	0	-3	3	-3/3
ENSG00000123353	ENSG00000135392	0	306	100	306	0	-1	1	-1/1
ENSG00000123353	ENSG00000135392	0	306	100	306	0	-2	2	-2/2
ENSG00000123353	ENSG00000135392	0	306	100	306	0	1	-1	1/-1
ENSG00000123353	ENSG00000135392	0	306	100	306	0	-3	1	-3/1
ENSG00000123353	ENSG00000135392	0	306	100	306	0	-1	2	-1/2
ENSG00000123353	ENSG00000135392	0	306	100	306	0	-2	3	-2/3
ENSG00000122691	ENSG00000233608	5.43e-59	104	92.308	96	8	1	2	1/2
ENSG00000122691	ENSG00000233608	5.43e-59	104	92.308	96	8	1	2	1/2
ENSG00000121075	ENSG00000089225	9.99e-147	197	90.863	179	18	1	2	1/2
ENSG00000059122	ENSG00000162076	6.52e-49	67	85.075	57	10	-3	-2	-3/-2
ENSG00000132915	ENSG00000133256	0	326	82.209	268	58	1	2	1/2
ENSG00000160145	ENSG00000038382	0	182	86.264	157	25	2	1	2/1
ENSG00000134072	ENSG00000183049	0	323	82.353	266	57	2	3	2/3
ENSG00000115042	ENSG00000144199	0	329	96.657	318	11	-1	-3	-1/-3
ENSG00000134250	ENSG00000264343	2.6e-159	238	97.479	232	6	3	1	3/1
ENSG00000128383	ENSG00000179750	7.76e-173	229	93.886	215	14	3	1	3/1
ENSG00000115297	ENSG00000164438	5.91e-51	83	87.952	73	10	3	2	3/2
ENSG00000123136	ENSG00000198563	0	403	91.811	370	33	1	2	1/2
ENSG00000121350	ENSG00000004700	0	481	99.376	478	3	3	-3	3/-3
ENSG00000128340	ENSG00000136238	6.04e-122	197	90.863	179	18	3	1	3/1
ENSG00000128340	ENSG00000169750	9.71e-120	203	85.714	174	29	3	1	3/1
ENSG00000239305	ENSG00000249884	8.67e-27	54	92.593	50	4	-3	-1	-3/-1
ENSG00000125148	ENSG00000198417	2.21e-32	51	94.118	48	3	-1	-3	-1/-3
ENSG00000130037	ENSG00000177301	2.82e-172	161	84.472	136	25	1	3	1/3
ENSG00000130037	ENSG00000177301	2.84e-172	161	84.472	136	25	1	2	1/2
ENSG00000128335	ENSG00000100342	0	170	84.706	144	26	1	2	1/2
ENSG00000127831	ENSG00000135913	0	705	100	705	0	2	-2	2/-2
ENSG00000115486	ENSG00000168906	3.62e-126	185	100	185	0	3	-3	3/-3
ENSG00000115486	ENSG00000168906	7.4e-119	185	100	185	0	-3	2	-3/2
ENSG00000130766	ENSG00000080546	4.54e-168	150	80	120	30	1	3	1/3
ENSG00000120738	ENSG00000179388	2.49e-71	113	85.841	97	16	3	2	3/2
ENSG00000120738	ENSG00000179388	2.53e-71	113	85.841	97	16	3	2	3/2
ENSG00000120903	ENSG00000101204	0	307	80.13	246	61	3	2	3/2
ENSG00000120709	ENSG00000158402	2.84e-58	104	89.423	93	11	3	-3	3/-3
ENSG00000126550	ENSG00000205649	1.69e-94	88	82.955	73	15	1	2	1/2
ENSG00000215397	ENSG00000261678	4.79e-93	135	91.111	123	12	3	2	3/2
ENSG00000129862	ENSG00000169059	1.17e-68	87	90.805	79	8	-2	-3	-2/-3
ENSG00000100056	ENSG00000206203	0	605	100	605	0	-3	2	-3/2
ENSG00000100056	ENSG00000212122	1.24e-163	277	82.31	228	49	-3	1	-3/1
ENSG00000133488	ENSG00000214491	0	229	82.969	190	39	-2	-1	-2/-1
ENSG00000171903	ENSG00000186529	0	488	86.68	423	65	2	3	2/3
ENSG00000115386	ENSG00000172023	2.78e-108	217	81.106	176	41	-2	-1	-2/-1
ENSG00000100722	ENSG00000165521	0	839	100	839	0	3	-2	3/-2
ENSG00000124216	ENSG00000019549	1.92e-75	113	85.841	97	16	2	3	2/3
ENSG00000134108	ENSG00000143862	2.85e-115	183	91.257	167	16	1	2	1/2
ENSG00000124212	ENSG00000180979	1.36e-115	53	81.132	43	10	-1	3	-1/3
ENSG00000171346	ENSG00000171401	1.95e-171	316	85.443	270	46	2	3	2/3
ENSG00000125398	ENSG00000100146	4.27e-128	121	90.909	110	11	1	2	1/2
ENSG00000125398	ENSG00000100146	4.4e-128	121	90.909	110	11	1	2	1/2
ENSG00000120137	ENSG00000125779	0	202	81.683	165	37	3	1	3/1
ENSG00000083307	ENSG00000134317	0	53	92.453	49	4	3	2	3/2
ENSG00000122696	ENSG00000141437	0	306	95.425	292	14	-2	-1	-2/-1
ENSG00000127720	ENSG00000133773	1.31e-58	97	100	97	0	1	-3	1/-3
ENSG00000130254	ENSG00000160633	0	161	81.366	131	30	-1	-2	-1/-2
ENSG00000115844	ENSG00000064195	2.25e-46	88	82.955	73	15	3	2	3/2
ENSG00000269741	ENSG00000213022	4.41e-173	251	100	251	0	-3	-1	-3/-1
ENSG00000269741	ENSG00000213022	1.14e-152	251	100	251	0	-1	-2	-1/-2
ENSG00000269741	ENSG00000129455	6.79e-86	103	99.029	102	1	-3	-2	-3/-2
ENSG00000077312	ENSG00000125870	5.27e-90	80	86.25	69	11	2	1	2/1
ENSG00000037042	ENSG00000131462	0	465	96.344	448	17	2	3	2/3
ENSG00000124217	ENSG00000138592	8.11e-25	56	80.357	45	11	3	1	3/1
ENSG00000058262	ENSG00000065665	0	475	93.684	445	30	2	3	2/3
ENSG00000130402	ENSG00000072110	0	883	86.75	766	117	2	1	2/1
ENSG00000122728	ENSG00000147133	0	847	92.798	786	61	3	1	3/1
ENSG00000125347	ENSG00000003402	3.82e-117	118	83.898	99	19	1	-2	1/-2
ENSG00000121351	ENSG00000135966	7e-44	95	80	76	19	-3	1	-3/1
ENSG00000119729	ENSG00000151665	2.05e-143	219	100	219	0	2	-1	2/-1
ENSG00000119729	ENSG00000126785	4.2e-100	190	80	152	38	2	1	2/1
ENSG00000125249	ENSG00000123728	1.75e-93	184	91.304	168	16	1	3	1/3
ENSG00000213463	ENSG00000258644	1.78e-82	137	94.891	130	7	2	1	2/1
ENSG00000213463	ENSG00000258644	2.45e-66	137	94.891	130	7	-2	-1	-2/-1
ENSG00000124172	ENSG00000101162	0	395	100	395	0	-2	3	-2/3
ENSG00000124172	ENSG00000101162	0	395	100	395	0	1	-2	1/-2
ENSG00000124172	ENSG00000101162	0	395	100	395	0	2	-3	2/-3
ENSG00000116035	ENSG00000148704	8.93e-57	97	90.722	88	9	3	1	3/1
ENSG00000130449	ENSG00000162415	0	532	80.263	427	105	1	3	1/3
ENSG00000125735	ENSG00000175782	4.78e-58	50	80	40	10	-3	-1	-3/-1
ENSG00000125735	ENSG00000175782	2.67e-47	50	80	40	10	1	3	1/3
ENSG00000124766	ENSG00000176887	1.16e-68	88	93.182	82	6	1	2	1/2
ENSG00000126822	ENSG00000070182	0	558	100	558	0	-2	1	-2/1
ENSG00000126822	ENSG00000070182	0	558	100	558	0	-2	2	-2/2
ENSG00000119778	ENSG00000156802	0	335	81.791	274	61	3	1	3/1
ENSG00000128011	ENSG00000165379	2.44e-174	62	83.871	52	10	1	2	1/2
ENSG00000132394	ENSG00000175792	6.28e-29	55	100	55	0	1	-1	1/-1
ENSG00000127529	ENSG00000127530	1.99e-136	56	85.714	48	8	-3	-2	-3/-2
ENSG00000127529	ENSG00000127530	1.99e-136	56	85.714	48	8	-3	-2	-3/-2
ENSG00000130544	ENSG00000167785	0	170	81.765	139	31	-2	-1	-2/-1
ENSG00000128245	ENSG00000170027	4.01e-142	246	86.992	214	32	1	2	1/2
ENSG00000127824	ENSG00000123416	0	438	97.489	427	11	1	3	1/3
ENSG00000133703	ENSG00000174775	1.24e-98	188	85.106	160	28	2	3	2/3
ENSG00000133243	ENSG00000064726	0	379	84.697	321	58	1	3	1/3
ENSG00000120094	ENSG00000105991	5.2e-38	54	85.185	46	8	1	2	1/2
ENSG00000120094	ENSG00000105991	1e-37	54	85.185	46	8	1	3	1/3
ENSG00000253159	ENSG00000253846	1.67e-153	69	94.203	65	4	1	3	1/3
ENSG00000120329	ENSG00000102743	0	315	86.667	273	42	1	3	1/3
ENSG00000125414	ENSG00000109061	0	629	93.482	588	41	2	3	2/3
ENSG00000131480	ENSG00000131471	0	159	84.906	135	24	1	2	1/2
ENSG00000125459	ENSG00000116580	0	225	91.111	205	20	2	-1	2/-1
ENSG00000125459	ENSG00000116580	0	225	91.111	205	20	2	-3	2/-3
ENSG00000112659	ENSG00000044090	0	210	85.714	180	30	-3	-1	-3/-1
ENSG00000112659	ENSG00000044090	0	210	85.714	180	30	-3	-1	-3/-1
ENSG00000115392	ENSG00000028116	3.69e-94	159	96.226	153	6	2	-2	2/-2
ENSG00000106526	ENSG00000133627	7.79e-140	217	93.088	202	15	-3	-2	-3/-2
ENSG00000274618	ENSG00000276966	6.28e-40	86	87.209	75	11	-2	-1	-2/-1
ENSG00000131459	ENSG00000198380	0	446	81.166	362	84	3	1	3/1
ENSG00000131459	ENSG00000198380	0	446	81.166	362	84	3	1	3/1
ENSG00000130283	ENSG00000223802	0	260	100	260	0	-2	-1	-2/-1
ENSG00000197375	ENSG00000197208	0	322	86.025	277	45	3	1	3/1
ENSG00000264424	ENSG00000109061	0	862	95.592	824	38	1	3	1/3
ENSG00000264424	ENSG00000125414	0	635	91.969	584	51	1	3	1/3
ENSG00000132603	ENSG00000272617	5e-49	79	100	79	0	1	-2	1/-2
ENSG00000132603	ENSG00000272617	2.45e-44	79	100	79	0	-3	2	-3/2
ENSG00000198342	ENSG00000196466	0	522	80.651	421	101	-1	-2	-1/-2
ENSG00000282608	ENSG00000121933	9.94e-121	163	100	163	0	1	2	1/2
ENSG00000260027	ENSG00000108511	1.15e-35	66	89.394	59	7	1	2	1/2
ENSG00000132517	ENSG00000185803	0	108	83.333	90	18	2	3	2/3
ENSG00000124610	ENSG00000168298	2.6e-28	79	87.342	69	10	1	2	1/2
ENSG00000124657	ENSG00000168131	5.33e-171	310	81.613	253	57	1	3	1/3
ENSG00000104974	ENSG00000104972	0	496	83.266	413	83	-2	-1	-2/-1
ENSG00000124608	ENSG00000140093	1.04e-47	99	80.808	80	19	1	-1	1/-1
ENSG00000132207	ENSG00000181625	0	244	100	244	0	2	1	2/1
ENSG00000134590	ENSG00000203950	1.66e-171	179	86.592	155	24	-3	-2	-3/-2
ENSG00000134590	ENSG00000212747	1.28e-158	179	87.709	157	22	-3	-1	-3/-1
ENSG00000126890	ENSG00000268651	1.03e-104	150	85.333	128	22	3	1	3/1
ENSG00000170465	ENSG00000185479	0	190	100	190	0	-2	-1	-2/-1
ENSG00000109805	ENSG00000178177	0	474	100	474	0	-2	1	-2/1
ENSG00000118579	ENSG00000047662	0	1107	100	1107	0	3	-1	3/-1
ENSG00000118579	ENSG00000175782	4.74e-111	66	81.818	54	12	3	-3	3/-3
ENSG00000124733	ENSG00000112640	9.5e-56	83	100	83	0	1	-1	1/-1
ENSG00000124733	ENSG00000112640	9.47e-52	83	100	83	0	-1	3	-1/3
ENSG00000124733	ENSG00000112640	9.5e-56	83	100	83	0	1	-1	1/-1
ENSG00000124733	ENSG00000112640	9.47e-52	83	100	83	0	-1	3	-1/3
ENSG00000119638	ENSG00000160602	4.07e-74	71	87.324	62	9	2	1	2/1
ENSG00000119638	ENSG00000119703	1.41e-149	211	100	211	0	-2	2	-2/2
ENSG00000119638	ENSG00000119703	8.79e-144	211	100	211	0	2	-1	2/-1
ENSG00000119638	ENSG00000119703	2.28e-143	211	100	211	0	-1	1	-1/1
ENSG00000119638	ENSG00000119703	2.89e-142	211	100	211	0	1	-3	1/-3
ENSG00000119638	ENSG00000119703	6.4e-140	211	100	211	0	-3	3	-3/3
ENSG00000169951	ENSG00000261459	0	122	81.967	100	22	-1	-3	-1/-3
ENSG00000130950	ENSG00000188152	0	377	97.347	367	10	-3	-1	-3/-1
ENSG00000133935	ENSG00000075643	3.05e-25	55	80	44	11	3	1	3/1
ENSG00000125966	ENSG00000156103	0	176	85.227	150	26	2	1	2/1
ENSG00000125966	ENSG00000157227	0	112	81.25	91	21	2	1	2/1
ENSG00000131873	ENSG00000198108	0	371	80.054	297	74	3	2	3/2
ENSG00000131368	ENSG00000177463	2.53e-168	252	100	252	0	-1	2	-1/2
ENSG00000131368	ENSG00000177463	8.34e-159	252	100	252	0	3	-1	3/-1
ENSG00000134538	ENSG00000111700	0	520	80	416	104	1	2	1/2
ENSG00000094796	ENSG00000006059	0	359	95.822	344	15	3	1	3/1
ENSG00000094796	ENSG00000131738	2.05e-177	192	93.229	179	13	-3	-2	-3/-2
ENSG00000134308	ENSG00000166913	7.32e-127	229	83.406	191	38	1	2	1/2
ENSG00000204577	ENSG00000244482	0	401	94.763	380	21	3	2	3/2
ENSG00000123143	ENSG00000065243	0	331	80.363	266	65	1	3	1/3
ENSG00000196757	ENSG00000171291	0	112	88.393	99	13	-2	-3	-2/-3
ENSG00000262246	ENSG00000103426	0	598	100	598	0	-3	-1	-3/-1
ENSG00000187545	ENSG00000204479	0	489	86.912	425	64	-3	-2	-3/-2
ENSG00000116132	ENSG00000167157	7.02e-60	71	92.958	66	5	2	3	2/3
ENSG00000100890	ENSG00000258790	0	485	99.381	482	3	-2	-3	-2/-3
ENSG00000074800	ENSG00000111674	0	431	83.991	362	69	1	3	1/3
ENSG00000132570	ENSG00000162408	1.17e-32	101	80.198	81	20	1	3	1/3
ENSG00000123739	ENSG00000153721	4.15e-76	65	80	52	13	2	1	2/1
ENSG00000131626	ENSG00000139220	0	112	83.929	94	18	3	2	3/2
ENSG00000133256	ENSG00000132915	5.22e-32	71	80.282	57	14	-3	3	-3/3
ENSG00000134253	ENSG00000185345	6.5e-38	53	84.906	45	8	2	-1	2/-1
ENSG00000103449	ENSG00000256463	0	163	80.368	131	32	2	1	2/1
ENSG00000099822	ENSG00000138622	0	550	90	495	55	3	2	3/2
ENSG00000099822	ENSG00000164588	0	545	85.138	464	81	3	2	3/2
ENSG00000133773	ENSG00000127720	3.76e-64	97	100	97	0	-1	2	-1/2
ENSG00000133773	ENSG00000127720	1.24e-58	97	100	97	0	-3	1	-3/1
ENSG00000133773	ENSG00000127720	7.1e-56	97	100	97	0	2	-3	2/-3
ENSG00000134365	ENSG00000116785	0	191	80.105	153	38	1	3	1/3
ENSG00000129450	ENSG00000168995	0	220	85.455	188	32	2	1	2/1
ENSG00000129864	ENSG00000169059	1.17e-68	87	90.805	79	8	-2	-3	-2/-3
ENSG00000129204	ENSG00000170832	0	779	92.94	724	55	-2	-3	-2/-3
ENSG00000131668	ENSG00000043039	8.04e-46	72	80.556	58	14	2	1	2/1
ENSG00000033800	ENSG00000129007	0	1004	100	1004	0	1	-1	1/-1
ENSG00000129028	ENSG00000137821	4.26e-63	114	100	114	0	1	-1	1/-1
ENSG00000129028	ENSG00000137821	2.26e-55	114	100	114	0	-3	2	-3/2
ENSG00000105717	ENSG00000185630	1.81e-136	183	81.967	150	33	3	1	3/1
ENSG00000243073	ENSG00000204501	0	608	98.191	597	11	3	2	3/2
ENSG00000243073	ENSG00000239810	0	493	95.943	473	20	-1	-3	-1/-3
ENSG00000188536	ENSG00000206172	5.22e-112	178	95.506	170	8	1	2	1/2
ENSG00000126803	ENSG00000109971	0	423	88.416	374	49	2	1	2/1
ENSG00000182415	ENSG00000129873	0	651	100	651	0	-1	-2	-1/-2
ENSG00000127364	ENSG00000104848	4.22e-51	96	83.333	80	16	-1	-3	-1/-3
ENSG00000127364	ENSG00000163807	1.5e-46	101	82.178	83	18	3	-1	3/-1
ENSG00000127364	ENSG00000163807	1.5e-46	101	82.178	83	18	-2	3	-2/3
ENSG00000127515	ENSG00000185385	8.46e-173	310	82.581	256	54	1	2	1/2
ENSG00000197757	ENSG00000106006	3.84e-53	86	81.395	70	16	3	2	3/2
ENSG00000119669	ENSG00000170604	9.54e-134	84	89.286	75	9	2	1	2/1
ENSG00000119669	ENSG00000168264	1.62e-75	61	85.246	52	9	-3	-2	-3/-2
ENSG00000134049	ENSG00000267228	1.4e-80	108	98.148	106	2	-3	-1	-3/-1
ENSG00000128713	ENSG00000005073	5.86e-68	77	89.61	69	8	2	1	2/1
ENSG00000128713	ENSG00000123388	5.88e-51	80	87.5	70	10	2	3	2/3
ENSG00000213366	ENSG00000134184	0	385	87.532	337	48	2	3	2/3
ENSG00000213366	ENSG00000168765	0	319	83.386	266	53	3	1	3/1
ENSG00000119673	ENSG00000184227	0	304	98.355	299	5	-3	-2	-3/-2
ENSG00000127415	ENSG00000145217	2.02e-27	52	94.231	49	3	2	-1	2/-1
ENSG00000124882	ENSG00000152700	5.35e-43	66	81.818	54	12	1	2	1/2
ENSG00000128590	ENSG00000177683	3.54e-27	52	100	52	0	1	-1	1/-1
ENSG00000187272	ENSG00000241595	4.92e-135	172	83.14	143	29	-1	-2	-1/-2
ENSG00000127220	ENSG00000130312	4.67e-30	71	95.775	68	3	3	-3	3/-3
ENSG00000105819	ENSG00000105821	2.5e-48	58	91.379	53	5	1	-1	1/-1
ENSG00000125878	ENSG00000260428	1.75e-33	58	82.759	48	10	3	1	3/1
ENSG00000130741	ENSG00000131174	7.27e-33	51	84.314	43	8	-2	-1	-2/-1
ENSG00000116455	ENSG00000116459	3.08e-70	112	97.321	109	3	-2	3	-2/3
ENSG00000117281	ENSG00000265491	1.91e-88	140	100	140	0	3	-1	3/-1
ENSG00000117281	ENSG00000265491	4.57e-83	140	100	140	0	-2	1	-2/1
ENSG00000234906	ENSG00000224916	1.1e-139	168	100	168	0	2	1	2/1
ENSG00000105613	ENSG00000086015	0	557	80.969	451	106	1	2	1/2
ENSG00000095110	ENSG00000137634	4.87e-152	217	81.567	177	40	-3	-2	-3/-2
ENSG00000130813	ENSG00000130812	4.35e-105	148	100	148	0	-1	2	-1/2
ENSG00000128709	ENSG00000180806	1.52e-47	68	95.588	65	3	2	3	2/3
ENSG00000185479	ENSG00000170465	0	190	100	190	0	-1	-2	-1/-2
ENSG00000185479	ENSG00000205420	0	190	97.895	186	4	-1	-2	-1/-2
ENSG00000122741	ENSG00000148734	3.82e-81	50	82	41	9	-1	-2	-1/-2
ENSG00000059145	ENSG00000090581	0	302	100	302	0	-2	2	-2/2
ENSG00000059145	ENSG00000090581	1.36e-177	302	100	302	0	-3	3	-3/3
ENSG00000186081	ENSG00000205420	0	355	90.141	320	35	2	1	2/1
ENSG00000186081	ENSG00000185479	0	355	90.141	320	35	2	1	2/1
ENSG00000130368	ENSG00000153721	1.85e-59	74	83.784	62	12	3	-3	3/-3
ENSG00000130368	ENSG00000265491	3.89e-59	97	82.474	80	17	3	1	3/1
ENSG00000128322	ENSG00000254709	1.79e-91	143	80.42	115	28	3	2	3/2
ENSG00000120328	ENSG00000197479	0	672	89.583	602	70	1	2	1/2
ENSG00000120328	ENSG00000120327	0	117	89.744	105	12	-3	-2	-3/-2
ENSG00000127780	ENSG00000180016	5.45e-164	192	91.667	176	16	-2	-1	-2/-1
ENSG00000131791	ENSG00000111725	2.94e-107	95	88.421	84	11	2	1	2/1
ENSG00000131791	ENSG00000111725	2.94e-107	95	88.421	84	11	2	3	2/3
ENSG00000129473	ENSG00000258643	1.23e-114	195	98.974	193	2	-3	-1	-3/-1
ENSG00000137273	ENSG00000103241	4.21e-66	113	96.46	109	4	1	2	1/2
ENSG00000104967	ENSG00000139910	0	228	85.526	195	33	1	3	1/3
ENSG00000136206	ENSG00000170092	5.52e-159	202	88.119	178	24	3	1	3/1
ENSG00000136206	ENSG00000205238	8.69e-164	202	86.634	175	27	3	1	3/1
ENSG00000007174	ENSG00000105877	0	323	80.805	261	62	3	2	3/2
ENSG00000139797	ENSG00000125352	2.22e-94	52	84.615	44	8	-2	-1	-2/-1
ENSG00000198610	ENSG00000187134	1.32e-164	222	81.982	182	40	-3	-2	-3/-2
ENSG00000111249	ENSG00000257923	0	116	80.172	93	23	2	3	2/3
ENSG00000111249	ENSG00000257923	0	116	80.172	93	23	2	3	2/3
ENSG00000087299	ENSG00000162924	3.8e-108	179	84.358	151	28	3	2	3/2
ENSG00000078177	ENSG00000101670	8.56e-34	76	81.579	62	14	3	-1	3/-1
ENSG00000011295	ENSG00000214941	7.42e-31	58	98.276	57	1	1	-1	1/-1
ENSG00000113712	ENSG00000180138	0	335	81.194	272	63	1	3	1/3
ENSG00000113712	ENSG00000180138	0	335	81.194	272	63	3	2	3/2
ENSG00000068654	ENSG00000126070	4.16e-20	52	82.692	43	9	1	-2	1/-2
ENSG00000139223	ENSG00000140350	3.26e-115	164	84.756	139	25	-1	-2	-1/-2
ENSG00000062716	ENSG00000141378	6.15e-30	54	100	54	0	1	-3	1/-3
ENSG00000062716	ENSG00000141378	2.57e-27	54	100	54	0	-1	1	-1/1
ENSG00000044090	ENSG00000112659	0	223	84.305	188	35	-1	-3	-1/-3
ENSG00000182187	ENSG00000163254	1.19e-98	83	95.181	79	4	1	3	1/3
ENSG00000182187	ENSG00000168582	4.43e-95	86	80.233	69	17	1	3	1/3
ENSG00000138030	ENSG00000138028	2.82e-88	65	93.846	61	4	-1	1	-1/1
ENSG00000143995	ENSG00000134138	0	158	86.076	136	22	2	1	2/1
ENSG00000139648	ENSG00000186049	0	365	89.315	326	39	2	3	2/3
ENSG00000139648	ENSG00000170484	0	364	87.088	317	47	2	1	2/1
ENSG00000077044	ENSG00000102780	0	277	81.227	225	52	1	2	1/2
ENSG00000118094	ENSG00000019144	7.93e-157	241	100	241	0	3	-1	3/-1
ENSG00000109158	ENSG00000145863	0	334	83.533	279	55	3	2	3/2
ENSG00000138083	ENSG00000184302	2.24e-131	210	86.667	182	28	1	2	1/2
ENSG00000139725	ENSG00000188735	0	581	100	581	0	-1	3	-1/3
ENSG00000081181	ENSG00000100568	0	256	100	256	0	-3	3	-3/3
ENSG00000081181	ENSG00000100568	0	256	100	256	0	1	-1	1/-1
ENSG00000072310	ENSG00000198911	3.28e-158	56	82.143	46	10	3	2	3/2
ENSG00000135587	ENSG00000185250	3.33e-73	136	100	136	0	-1	1	-1/1
ENSG00000135587	ENSG00000185250	3.33e-73	136	100	136	0	-1	1	-1/1
ENSG00000181381	ENSG00000137628	0	150	80.667	121	29	3	2	3/2
ENSG00000138109	ENSG00000165841	0	513	88.499	454	59	3	1	3/1
ENSG00000138109	ENSG00000108242	0	484	81.818	396	88	1	2	1/2
ENSG00000135679	ENSG00000215193	2.95e-99	98	82.653	81	17	3	2	3/2
ENSG00000085563	ENSG00000005471	0	532	83.083	442	90	2	1	2/1
ENSG00000014138	ENSG00000005156	6.79e-51	98	85.714	84	14	2	3	2/3
ENSG00000014138	ENSG00000092871	6.79e-51	98	85.714	84	14	2	-1	2/-1
ENSG00000141258	ENSG00000167037	0	67	83.582	56	11	1	2	1/2
ENSG00000090382	ENSG00000171109	7.95e-57	98	91.837	90	8	-3	-1	-3/-1
ENSG00000090382	ENSG00000164403	6.27e-54	98	87.755	86	12	-3	1	-3/1
ENSG00000143226	ENSG00000072694	0	191	89.005	170	21	-1	-3	-1/-3
ENSG00000127804	ENSG00000148297	4.67e-69	51	80.392	41	10	3	-2	3/-2
ENSG00000127804	ENSG00000205085	1.83e-46	56	80.357	45	11	3	2	3/2
ENSG00000187122	ENSG00000145147	0	212	83.491	177	35	1	2	1/2
ENSG00000005339	ENSG00000100393	0	471	90.446	426	45	1	2	1/2
ENSG00000100902	ENSG00000258790	1.25e-169	248	100	248	0	1	3	1/3
ENSG00000135945	ENSG00000158417	3.61e-180	284	100	284	0	3	-1	3/-1
ENSG00000126583	ENSG00000154229	0	146	80.137	117	29	1	3	1/3
ENSG00000126583	ENSG00000166501	0	146	81.507	119	27	1	3	1/3
ENSG00000072315	ENSG00000133107	0	270	80.741	218	52	2	1	2/1
ENSG00000072315	ENSG00000133107	0	270	80.741	218	52	2	1	2/1
ENSG00000075131	ENSG00000160961	3.27e-32	92	80.435	74	18	1	-1	1/-1
ENSG00000196943	ENSG00000136305	0	213	99.531	212	1	2	-2	2/-2
ENSG00000137285	ENSG00000137267	0	428	98.832	423	5	-3	-1	-3/-1
ENSG00000137285	ENSG00000104833	0	438	86.986	381	57	-3	-1	-3/-1
ENSG00000139625	ENSG00000197111	0	497	100	497	0	-2	2	-2/2
ENSG00000139625	ENSG00000197111	0	497	100	497	0	-2	1	-2/1
ENSG00000113504	ENSG00000124140	0	548	81.204	445	103	3	2	3/2
ENSG00000113504	ENSG00000124140	0	548	81.204	445	103	3	2	3/2
ENSG00000136698	ENSG00000152093	0	250	99.6	249	1	3	1	3/1
ENSG00000138685	ENSG00000170917	5.27e-138	196	98.98	194	2	2	-2	2/-2
ENSG00000137880	ENSG00000104129	6.83e-129	161	100	161	0	2	-2	2/-2
ENSG00000137880	ENSG00000104129	1.98e-122	161	100	161	0	-1	3	-1/3
ENSG00000137880	ENSG00000104129	1.61e-116	161	100	161	0	1	-1	1/-1
ENSG00000102753	ENSG00000186432	0	523	85.851	449	74	2	1	2/1
ENSG00000142178	ENSG00000275993	0	429	99.301	426	3	-1	-3	-1/-3
ENSG00000137766	ENSG00000198722	0	409	82.885	339	70	1	2	1/2
ENSG00000121594	ENSG00000113845	9.89e-160	266	100	266	0	-1	1	-1/1
ENSG00000140521	ENSG00000140525	2.3e-83	155	94.194	146	9	1	-1	1/-1
ENSG00000139053	ENSG00000185527	9.76e-42	70	94.286	66	4	2	3	2/3
ENSG00000139053	ENSG00000185527	9.76e-42	70	94.286	66	4	2	3	2/3
ENSG00000139291	ENSG00000160194	2.13e-96	61	81.967	50	11	-3	-1	-3/-1
ENSG00000139291	ENSG00000088888	3.01e-92	55	83.636	46	9	-3	1	-3/1
ENSG00000104833	ENSG00000188229	0	274	98.54	270	4	1	2	1/2
ENSG00000104833	ENSG00000196230	3.44e-168	112	88.393	99	13	-1	-2	-1/-2
ENSG00000122481	ENSG00000271092	1.28e-115	170	99.412	169	1	2	1	2/1
ENSG00000144136	ENSG00000168575	0	203	81.281	165	38	3	2	3/2
ENSG00000144136	ENSG00000168575	0	203	81.281	165	38	3	2	3/2
ENSG00000129159	ENSG00000131398	4.72e-139	201	81.592	164	37	-2	-3	-2/-3
ENSG00000109787	ENSG00000118922	1.92e-59	91	92.308	84	7	3	1	3/1
ENSG00000109787	ENSG00000102349	1.1e-52	88	84.091	74	14	3	1	3/1
ENSG00000083844	ENSG00000204524	0	511	85.519	437	74	1	3	1/3
ENSG00000072133	ENSG00000177189	0	295	86.102	254	41	3	2	3/2
ENSG00000076067	ENSG00000144642	1.02e-159	196	84.184	165	31	3	2	3/2
ENSG00000205045	ENSG00000172123	0	360	81.389	293	67	2	3	2/3
ENSG00000139946	ENSG00000197329	0	411	81.752	336	75	2	3	2/3
ENSG00000081019	ENSG00000187257	0	363	82.369	299	64	2	1	2/1
ENSG00000136240	ENSG00000105438	1.05e-123	213	83.568	178	35	3	1	3/1
ENSG00000141232	ENSG00000183864	1.74e-82	121	80.165	97	24	1	3	1/3
ENSG00000136319	ENSG00000123130	3.66e-40	87	81.609	71	16	-2	-1	-2/-1
ENSG00000136319	ENSG00000123130	4.29e-38	87	81.609	71	16	-3	-2	-3/-2
ENSG00000136319	ENSG00000010404	1.94e-40	88	82.955	73	15	-3	-2	-3/-2
ENSG00000105464	ENSG00000161509	0	418	83.493	349	69	2	1	2/1
ENSG00000136231	ENSG00000156928	0	506	100	506	0	2	-3	2/-3
ENSG00000136231	ENSG00000159217	0	188	80.319	151	37	1	2	1/2
ENSG00000136379	ENSG00000129968	2.42e-152	240	82.917	199	41	2	3	2/3
ENSG00000146216	ENSG00000128881	0	317	81.073	257	60	3	2	3/2
ENSG00000139289	ENSG00000054523	1.5e-42	92	82.609	76	16	2	3	2/3
ENSG00000141570	ENSG00000183741	8.94e-38	50	88	44	6	2	3	2/3
ENSG00000143954	ENSG00000172016	4.89e-127	215	84.651	182	33	-3	-2	-3/-2
ENSG00000100764	ENSG00000119720	0	567	99.471	564	3	3	-3	3/-3
ENSG00000121454	ENSG00000107187	1.23e-138	127	80.315	102	25	2	3	2/3
ENSG00000105402	ENSG00000125814	4.73e-156	292	84.247	246	46	1	3	1/3
ENSG00000083750	ENSG00000155876	0	273	97.802	267	6	3	2	3/2
ENSG00000084092	ENSG00000173559	2.84e-89	84	84.524	71	13	1	-1	1/-1
ENSG00000084092	ENSG00000177225	5.4e-87	90	86.667	78	12	1	-1	1/-1
ENSG00000136731	ENSG00000198393	2.47e-101	65	80	52	13	3	-2	3/-2
ENSG00000138600	ENSG00000215193	1.34e-31	70	81.429	57	13	2	-2	2/-2
ENSG00000138600	ENSG00000138592	0	56	80.357	45	11	-3	3	-3/3
ENSG00000076706	ENSG00000163428	1.31e-45	75	84	63	12	-3	-2	-3/-2
ENSG00000138442	ENSG00000175782	2.93e-70	85	80	68	17	1	3	1/3
ENSG00000117222	ENSG00000138035	1.01e-62	87	82.759	72	15	-3	-1	-3/-1
ENSG00000108963	ENSG00000262664	2.68e-168	231	100	231	0	2	1	2/1
ENSG00000119614	ENSG00000100987	3.09e-60	115	80	92	23	1	3	1/3
ENSG00000135643	ENSG00000152939	2.2e-28	67	82.09	55	12	-3	-1	-3/-1
ENSG00000101624	ENSG00000128789	2.09e-35	85	92.941	79	6	-3	2	-3/2
ENSG00000082701	ENSG00000105723	0	363	83.747	304	59	3	2	3/2
ENSG00000115112	ENSG00000135457	0	250	84.8	212	38	3	1	3/1
ENSG00000115112	ENSG00000153560	0	243	83.539	203	40	3	1	3/1
ENSG00000136536	ENSG00000241399	0	613	100	613	0	2	-3	2/-3
ENSG00000136536	ENSG00000241399	0	613	100	613	0	2	-3	2/-3
ENSG00000143786	ENSG00000100528	4.8e-58	51	82.353	42	9	1	3	1/3
ENSG00000135144	ENSG00000110042	0	183	82.514	151	32	3	2	3/2
ENSG00000139133	ENSG00000175548	4.09e-95	187	85.027	159	28	1	3	1/3
ENSG00000116017	ENSG00000179361	7.22e-100	138	83.333	115	23	3	1	3/1
ENSG00000116017	ENSG00000179361	1.25e-96	138	83.333	115	23	3	2	3/2
ENSG00000143951	ENSG00000014641	1.59e-38	63	100	63	0	-2	2	-2/2
ENSG00000143951	ENSG00000014641	5.67e-38	63	100	63	0	2	-3	2/-3
ENSG00000143951	ENSG00000014641	1.36e-36	63	100	63	0	1	-2	1/-2
ENSG00000143951	ENSG00000014641	4.47e-35	63	100	63	0	-3	3	-3/3
ENSG00000143951	ENSG00000014641	1.59e-34	63	100	63	0	3	-1	3/-1
ENSG00000143951	ENSG00000014641	3.53e-20	63	100	63	0	-1	1	-1/1
ENSG00000139266	ENSG00000144583	9.53e-99	159	90.566	144	15	3	1	3/1
ENSG00000141437	ENSG00000122696	0	311	93.248	290	21	3	2	3/2
ENSG00000099308	ENSG00000086015	0	359	83.844	301	58	1	2	1/2
ENSG00000099308	ENSG00000105613	0	202	83.168	168	34	-3	-2	-3/-2
ENSG00000107282	ENSG00000034053	0	347	83.862	291	56	2	3	2/3
ENSG00000107282	ENSG00000034053	0	347	83.862	291	56	2	1	2/1
ENSG00000107951	ENSG00000100784	2.73e-72	54	83.333	45	9	-2	-3	-2/-3
ENSG00000133026	ENSG00000133392	0	981	81.957	804	177	2	3	2/3
ENSG00000133026	ENSG00000133392	0	981	81.957	804	177	2	3	2/3
ENSG00000135452	ENSG00000135446	5.59e-114	168	100	168	0	1	-2	1/-2
ENSG00000135452	ENSG00000135446	7.1e-105	168	100	168	0	3	-1	3/-1
ENSG00000183668	ENSG00000221826	0	448	87.277	391	57	2	3	2/3
ENSG00000183668	ENSG00000243137	0	446	86.771	387	59	-2	-3	-2/-3
ENSG00000119048	ENSG00000077721	3e-98	158	93.038	147	11	1	3	1/3
ENSG00000143878	ENSG00000067560	2.61e-109	186	86.559	161	25	3	2	3/2
ENSG00000143878	ENSG00000155366	2.61e-109	182	88.462	161	21	3	2	3/2
ENSG00000126814	ENSG00000198830	1.41e-156	183	85.246	156	27	2	1	2/1
ENSG00000126814	ENSG00000198830	2.19e-157	183	85.246	156	27	2	3	2/3
ENSG00000142166	ENSG00000198393	2.83e-37	66	80.303	53	13	3	-3	3/-3
ENSG00000137720	ENSG00000175782	1.24e-57	56	82.143	46	10	-1	-2	-1/-2
ENSG00000092470	ENSG00000273274	2.96e-45	55	80	44	11	2	1	2/1
ENSG00000102882	ENSG00000100030	0	345	88.116	304	41	2	1	2/1
ENSG00000102882	ENSG00000100030	0	345	88.116	304	41	2	1	2/1
ENSG00000143933	ENSG00000160014	4.47e-98	153	99.346	152	1	3	2	3/2
ENSG00000142669	ENSG00000158062	8.73e-41	65	100	65	0	-1	2	-1/2
ENSG00000142669	ENSG00000158062	8.06e-40	65	100	65	0	3	-1	3/-1
ENSG00000135519	ENSG00000089558	2.89e-138	66	80.303	53	13	-3	-1	-3/-1
ENSG00000135116	ENSG00000108439	3.06e-51	67	80.597	54	13	1	3	1/3
ENSG00000135116	ENSG00000110723	3.51e-49	98	81.633	80	18	-3	-1	-3/-1
ENSG00000126934	ENSG00000169032	0	228	92.544	211	17	3	1	3/1
ENSG00000091664	ENSG00000104888	0	512	82.422	422	90	3	2	3/2
ENSG00000008710	ENSG00000214940	3.92e-54	73	97.26	71	2	2	1	2/1
ENSG00000008710	ENSG00000214940	1.29e-49	73	97.26	71	2	-1	-2	-1/-2
ENSG00000141385	ENSG00000176014	1.39e-149	213	100	213	0	1	-1	1/-1
ENSG00000141385	ENSG00000176014	3.92e-146	213	100	213	0	-3	2	-3/2
ENSG00000115239	ENSG00000270898	0	593	99.325	589	4	3	1	3/1
ENSG00000103769	ENSG00000185236	3.58e-61	98	80.612	79	19	-1	-2	-1/-2
ENSG00000109181	ENSG00000171234	0	556	83.273	463	93	3	1	3/1
ENSG00000109181	ENSG00000213759	0	495	89.697	444	51	-1	-2	-1/-2
ENSG00000145002	ENSG00000186523	0	309	99.676	308	1	-1	-2	-1/-2
ENSG00000104331	ENSG00000164615	1.59e-42	55	85.455	47	8	-2	-1	-2/-1
ENSG00000104331	ENSG00000153029	2.16e-42	55	81.818	45	10	2	-3	2/-3
ENSG00000104331	ENSG00000153029	1.6e-39	55	81.818	45	10	-3	3	-3/3
ENSG00000089091	ENSG00000104205	2.26e-38	99	82.828	82	17	1	3	1/3
ENSG00000135974	ENSG00000134748	5.43e-37	91	80.22	73	18	-3	-2	-3/-2
ENSG00000136327	ENSG00000125820	2.11e-31	67	85.075	57	10	3	1	3/1
ENSG00000115808	ENSG00000196792	0	99	83.838	83	16	1	3	1/3
ENSG00000135956	ENSG00000126070	6.07e-74	85	83.529	71	14	-1	2	-1/2
ENSG00000137133	ENSG00000137103	1.88e-24	51	84.314	43	8	-2	2	-2/2
ENSG00000006695	ENSG00000241322	1.23e-45	99	83.838	83	16	-2	1	-2/1
ENSG00000101670	ENSG00000198393	2.58e-84	50	80	40	10	-1	1	-1/1
ENSG00000137801	ENSG00000186340	0	261	83.142	217	44	1	3	1/3
ENSG00000137801	ENSG00000186340	0	261	83.142	217	44	1	2	1/2
ENSG00000103061	ENSG00000103064	0	977	100	977	0	2	-3	2/-3
ENSG00000103061	ENSG00000103064	0	977	100	977	0	2	-3	2/-3
ENSG00000137822	ENSG00000067369	1.69e-106	137	91.971	126	11	-2	1	-2/1
ENSG00000143867	ENSG00000164920	2.3e-109	103	92.233	95	8	1	2	1/2
ENSG00000143867	ENSG00000164920	2.3e-109	103	92.233	95	8	1	2	1/2
ENSG00000069956	ENSG00000141639	1.5e-145	180	80.556	145	35	1	2	1/2
ENSG00000240403	ENSG00000242019	0	70	87.143	61	9	-1	-2	-1/-2
ENSG00000104388	ENSG00000129472	3.69e-115	191	90.052	172	19	1	3	1/3
ENSG00000244754	ENSG00000138592	5.55e-139	58	81.034	47	11	1	-2	1/-2
ENSG00000165055	ENSG00000087995	0	458	95.633	438	20	1	3	1/3
ENSG00000144118	ENSG00000006451	1.34e-69	126	89.683	113	13	1	3	1/3
ENSG00000243709	ENSG00000143768	0	399	94.486	377	22	3	2	3/2
ENSG00000135175	ENSG00000122543	2.3e-153	231	98.268	227	4	-1	-3	-1/-3
ENSG00000110013	ENSG00000154144	0	562	100	562	0	-3	1	-3/1
ENSG00000143387	ENSG00000136943	2.33e-100	55	80	44	11	1	3	1/3
ENSG00000143387	ENSG00000136943	2.37e-100	55	80	44	11	1	2	1/2
ENSG00000138031	ENSG00000138092	0	257	99.222	255	2	-2	1	-2/1
ENSG00000135018	ENSG00000188021	0	163	90.184	147	16	1	2	1/2
ENSG00000084731	ENSG00000101350	0	115	82.609	95	20	2	3	2/3
ENSG00000114166	ENSG00000108773	0	252	81.349	205	47	3	1	3/1
ENSG00000089116	ENSG00000273706	5.93e-159	118	92.373	109	9	2	1	2/1
ENSG00000089558	ENSG00000183960	0	224	81.696	183	41	1	3	1/3
ENSG00000109220	ENSG00000204116	3.18e-73	148	83.108	123	25	1	3	1/3
ENSG00000124120	ENSG00000105519	1.52e-107	94	85.106	80	14	-2	2	-2/2
ENSG00000136213	ENSG00000100784	2.84e-180	97	81.443	79	18	-3	-1	-3/-1
ENSG00000138741	ENSG00000069018	0	422	84.123	355	67	3	2	3/2
ENSG00000110723	ENSG00000175782	1.04e-102	87	85.057	74	13	1	-2	1/-2
ENSG00000096746	ENSG00000169045	4.08e-64	77	84.416	65	12	-1	-3	-1/-3
ENSG00000064651	ENSG00000074803	0	184	82.065	151	33	1	3	1/3
ENSG00000113319	ENSG00000058335	0	319	85.266	272	47	2	3	2/3
ENSG00000113319	ENSG00000058335	0	319	85.266	272	47	2	3	2/3
ENSG00000135482	ENSG00000126070	3.31e-32	60	80	48	12	1	-1	1/-1
ENSG00000106511	ENSG00000005102	1.4e-38	75	88	66	9	3	1	3/1
ENSG00000106511	ENSG00000005102	5.64e-38	75	88	66	9	3	2	3/2
ENSG00000066027	ENSG00000154001	0	284	85.915	244	40	2	3	2/3
ENSG00000114656	ENSG00000119661	7.79e-114	55	90.909	50	5	-1	1	-1/1
ENSG00000077232	ENSG00000174749	0	152	80.921	123	29	-1	-3	-1/-3
ENSG00000143862	ENSG00000134108	1.64e-115	183	91.257	167	16	2	3	2/3
ENSG00000141965	ENSG00000145780	0	115	83.478	96	19	1	2	1/2
ENSG00000141965	ENSG00000138592	0	92	81.522	75	17	3	1	3/1
ENSG00000138079	ENSG00000138078	0	417	99.76	416	1	-1	3	-1/3
ENSG00000138079	ENSG00000138078	0	417	99.76	416	1	-1	2	-1/2
ENSG00000135100	ENSG00000157895	0	474	100	474	0	3	-1	3/-1
ENSG00000064726	ENSG00000133243	0	379	84.697	321	58	3	1	3/1
ENSG00000135185	ENSG00000135164	1.37e-32	57	100	57	0	-1	2	-1/2
ENSG00000135185	ENSG00000135164	4.16e-30	57	100	57	0	2	-3	2/-3
ENSG00000123124	ENSG00000198373	0	453	81.457	369	84	2	3	2/3
ENSG00000101003	ENSG00000175782	2e-74	74	83.784	62	12	-3	2	-3/2
ENSG00000007047	ENSG00000075413	0	335	85.97	288	47	2	1	2/1
ENSG00000103319	ENSG00000198393	1.04e-95	79	83.544	66	13	1	2	1/2
ENSG00000034533	ENSG00000017260	7.08e-36	65	96.923	63	2	-2	1	-2/1
ENSG00000062038	ENSG00000039068	3.22e-137	91	81.319	74	17	-1	-2	-1/-2
ENSG00000100418	ENSG00000161405	8.94e-48	90	81.111	73	17	-2	-3	-2/-3
ENSG00000100418	ENSG00000161405	9.27e-48	90	81.111	73	17	-2	-3	-2/-3
ENSG00000139278	ENSG00000111615	0	379	99.736	378	1	2	-2	2/-2
ENSG00000139719	ENSG00000180488	5.57e-65	84	80.952	68	16	-2	1	-2/1
ENSG00000139719	ENSG00000180488	6.75e-65	84	80.952	68	16	-2	1	-2/1
ENSG00000116199	ENSG00000177225	1.03e-59	54	81.481	44	10	-2	3	-2/3
ENSG00000113721	ENSG00000134853	0	154	80.519	124	30	3	2	3/2
ENSG00000144063	ENSG00000164916	1.07e-47	62	80.645	50	12	-1	-3	-1/-3
ENSG00000144063	ENSG00000145012	3.72e-30	54	81.481	44	10	-1	-2	-1/-2
ENSG00000105610	ENSG00000136826	9.01e-58	104	80.769	84	20	3	1	3/1
ENSG00000140323	ENSG00000215193	9.84e-101	99	80.808	80	19	-3	-1	-3/-1
ENSG00000140323	ENSG00000136213	0	98	83.673	82	16	2	-1	2/-1
ENSG00000127412	ENSG00000165125	1.25e-148	193	84.974	164	29	1	3	1/3
ENSG00000127412	ENSG00000165125	5.34e-148	193	84.974	164	29	1	3	1/3
ENSG00000137040	ENSG00000065150	0	877	82.326	722	155	3	1	3/1
ENSG00000089902	ENSG00000117625	5.09e-139	129	83.721	108	21	2	3	2/3
ENSG00000089902	ENSG00000117625	7.13e-139	129	83.721	108	21	2	3	2/3
ENSG00000140678	ENSG00000169896	4.66e-115	80	80	64	16	3	2	3/2
ENSG00000123268	ENSG00000118260	2.6e-74	68	80.882	55	13	2	3	2/3
ENSG00000123268	ENSG00000118260	2.6e-74	68	80.882	55	13	2	1	2/1
ENSG00000137845	ENSG00000125741	9.5e-39	50	84	42	8	-3	-1	-3/-1
ENSG00000129933	ENSG00000105705	7.83e-29	50	100	50	0	2	-2	2/-2
ENSG00000129933	ENSG00000105705	2.58e-27	50	100	50	0	-3	3	-3/3
ENSG00000144119	ENSG00000165985	1.2e-92	132	88.636	117	15	3	2	3/2
ENSG00000141429	ENSG00000144278	0	505	85.941	434	71	2	1	2/1
ENSG00000135097	ENSG00000153944	2.1e-134	175	85.714	150	25	3	1	3/1
ENSG00000120658	ENSG00000165675	0	159	84.277	134	25	3	2	3/2
ENSG00000120658	ENSG00000165675	0	159	84.277	134	25	3	2	3/2
ENSG00000099337	ENSG00000175782	2.47e-103	67	80.597	54	13	-2	-3	-2/-3
ENSG00000099337	ENSG00000138592	1.95e-134	85	80	68	17	-1	-3	-1/-3
ENSG00000135245	ENSG00000130368	6.24e-41	70	85.714	60	10	-2	-1	-2/-1
ENSG00000135443	ENSG00000170523	0	299	91.639	274	25	2	1	2/1
ENSG00000135443	ENSG00000170442	1.02e-172	179	90.503	162	17	-3	-1	-3/-1
ENSG00000143869	ENSG00000156466	1.68e-57	95	85.263	81	14	1	2	1/2
ENSG00000134897	ENSG00000171109	6.49e-26	75	81.333	61	14	3	-3	3/-3
ENSG00000007384	ENSG00000129667	0	208	80.288	167	41	3	2	3/2
ENSG00000080371	ENSG00000215193	6.7e-104	94	85.106	80	14	3	1	3/1
ENSG00000080371	ENSG00000153721	2.8e-93	54	81.481	44	10	-3	2	-3/2
ENSG00000205084	ENSG00000136213	1.14e-82	54	81.481	44	10	-1	1	-1/1
ENSG00000205084	ENSG00000198393	3.42e-67	55	83.636	46	9	-1	2	-1/2
ENSG00000100393	ENSG00000005339	0	490	88.163	432	58	2	1	2/1
ENSG00000100393	ENSG00000005339	0	490	88.163	432	58	2	1	2/1
ENSG00000058056	ENSG00000111667	0	71	80.282	57	14	1	3	1/3
ENSG00000058056	ENSG00000111667	0	71	80.282	57	14	1	2	1/2
ENSG00000075643	ENSG00000157350	1.7e-77	85	82.353	70	15	-3	2	-3/2
ENSG00000140379	ENSG00000180953	4.37e-41	73	82.192	60	13	-1	-3	-1/-3
ENSG00000138622	ENSG00000099822	0	562	88.612	498	64	2	3	2/3
ENSG00000139112	ENSG00000170296	1.39e-68	116	87.069	101	15	2	3	2/3
ENSG00000136842	ENSG00000136925	0	555	100	555	0	-1	3	-1/3
ENSG00000110048	ENSG00000184792	1.62e-105	50	80	40	10	-3	-2	-3/-2
ENSG00000110048	ENSG00000184792	1.34e-131	50	80	40	10	-3	-2	-3/-2
ENSG00000112246	ENSG00000159263	0	359	86.072	309	50	3	2	3/2
ENSG00000104903	ENSG00000162367	9.37e-31	62	85.484	53	9	2	1	2/1
ENSG00000116254	ENSG00000111642	0	349	86.533	302	47	2	3	2/3
ENSG00000116254	ENSG00000111642	0	349	86.533	302	47	2	3	2/3
ENSG00000103740	ENSG00000166411	0	870	100	870	0	-1	1	-1/1
ENSG00000105865	ENSG00000164597	4.25e-40	84	100	84	0	1	-3	1/-3
ENSG00000105865	ENSG00000164597	4.25e-40	84	100	84	0	1	-3	1/-3
ENSG00000127993	ENSG00000141759	3.38e-27	52	80.769	42	10	-2	2	-2/2
ENSG00000127993	ENSG00000197299	2.89e-40	51	84.314	43	8	1	-2	1/-2
ENSG00000081014	ENSG00000104205	1.14e-49	55	83.636	46	9	3	-2	3/-2
ENSG00000139233	ENSG00000143458	2.55e-99	91	83.516	76	15	-2	-3	-2/-3
ENSG00000014824	ENSG00000175782	1.18e-44	56	82.143	46	10	3	-3	3/-3
ENSG00000240303	ENSG00000081307	0	294	99.66	293	1	-1	3	-1/3
ENSG00000116489	ENSG00000198898	1.19e-164	288	86.806	250	38	1	2	1/2
ENSG00000116489	ENSG00000007341	2.66e-50	82	100	82	0	1	-2	1/-2
ENSG00000116489	ENSG00000007341	6.37e-41	82	100	82	0	-3	1	-3/1
ENSG00000105808	ENSG00000170667	0	632	99.525	629	3	3	2	3/2
ENSG00000047457	ENSG00000163755	0	411	100	411	0	2	-1	2/-1
ENSG00000125492	ENSG00000143032	7.08e-37	84	82.143	69	15	-2	-1	-2/-1
ENSG00000139180	ENSG00000003402	4.1e-139	198	91.414	181	17	-1	-3	-1/-3
ENSG00000139180	ENSG00000175387	1.12e-150	204	86.275	176	28	-2	-3	-2/-3
ENSG00000136881	ENSG00000205189	0	81	83.951	68	13	-1	1	-1/1
ENSG00000136682	ENSG00000172785	0	597	98.66	589	8	-1	-2	-1/-2
ENSG00000136682	ENSG00000196873	0	597	97.99	585	12	-1	-2	-1/-2
ENSG00000138758	ENSG00000125354	0	343	86.006	295	48	1	2	1/2
ENSG00000128039	ENSG00000180616	1.16e-59	61	81.967	50	11	2	1	2/1
ENSG00000111700	ENSG00000205754	0	220	83.636	184	36	-1	-3	-1/-3
ENSG00000128463	ENSG00000140199	2.33e-27	53	100	53	0	2	-3	2/-3
ENSG00000128463	ENSG00000140199	1.69e-23	53	100	53	0	-1	1	-1/1
ENSG00000128463	ENSG00000140199	8.29e-19	53	100	53	0	-3	3	-3/3
ENSG00000121879	ENSG00000171121	0	775	100	775	0	-3	3	-3/3
ENSG00000103241	ENSG00000137273	1.65e-68	127	90.551	115	12	2	1	2/1
ENSG00000115317	ENSG00000115318	2.28e-132	178	99.438	177	1	1	-3	1/-3
ENSG00000111412	ENSG00000138592	2.49e-108	92	80.435	74	18	-3	-1	-3/-1
ENSG00000101347	ENSG00000100784	1.54e-13	53	81.132	43	10	-1	1	-1/1
ENSG00000069011	ENSG00000164093	4.13e-99	91	86.813	79	12	1	3	1/3
ENSG00000135414	ENSG00000205323	4.16e-82	127	100	127	0	-2	3	-2/3
ENSG00000135414	ENSG00000205323	7.85e-82	127	100	127	0	2	-1	2/-1
ENSG00000130511	ENSG00000157216	3.48e-151	133	82.707	110	23	1	3	1/3
ENSG00000110987	ENSG00000106635	4.69e-32	62	85.484	53	9	3	2	3/2
ENSG00000067113	ENSG00000039123	4.27e-101	160	100	160	0	-2	1	-2/1
ENSG00000067113	ENSG00000039123	2.09e-100	160	100	160	0	2	-2	2/-2
ENSG00000067113	ENSG00000039123	1.93e-99	160	100	160	0	3	-3	3/-3
ENSG00000118620	ENSG00000197020	0	591	80.88	478	113	-1	-2	-1/-2
ENSG00000118620	ENSG00000196705	0	104	81.731	85	19	2	1	2/1
ENSG00000125741	ENSG00000072958	2.32e-92	51	80.392	41	10	2	-2	2/-2
ENSG00000125741	ENSG00000072958	1.21e-85	51	80.392	41	10	-2	3	-2/3
ENSG00000125741	ENSG00000119820	0	87	82.759	72	15	2	3	2/3
ENSG00000100815	ENSG00000066427	6.09e-113	170	100	170	0	-2	-3	-2/-3
ENSG00000100815	ENSG00000169239	1.08e-35	79	87.342	69	10	1	-1	1/-1
ENSG00000011523	ENSG00000103769	1.2e-52	58	82.759	48	10	-1	3	-1/3
ENSG00000055118	ENSG00000184611	0	266	88.346	235	31	1	2	1/2
ENSG00000142611	ENSG00000085276	0	190	85.789	163	27	2	3	2/3
ENSG00000138030	ENSG00000138028	2.77e-88	65	93.846	61	4	-1	1	-1/1
ENSG00000107341	ENSG00000099804	5.82e-120	196	86.735	170	26	3	2	3/2
ENSG00000213064	ENSG00000162924	4.18e-162	100	80	80	20	-3	3	-3/3
ENSG00000213064	ENSG00000173597	0	108	80.556	87	21	-1	-3	-1/-3
ENSG00000111684	ENSG00000126749	0	238	99.16	236	2	-1	3	-1/3
ENSG00000111684	ENSG00000105650	1.94e-28	52	80.769	42	10	3	-1	3/-1
ENSG00000263155	ENSG00000137878	0	502	99.602	500	2	1	2	1/2
ENSG00000128881	ENSG00000146216	0	314	81.529	256	58	2	3	2/3
ENSG00000160602	ENSG00000119638	5.74e-156	71	87.324	62	9	1	2	1/2
ENSG00000160602	ENSG00000161714	6.86e-61	88	82.955	73	15	-1	3	-1/3
ENSG00000134853	ENSG00000113721	0	152	81.579	124	28	2	3	2/3
ENSG00000117971	ENSG00000160716	0	283	80.212	227	56	2	1	2/1
ENSG00000129566	ENSG00000050438	1.16e-64	86	80.233	69	17	1	3	1/3
ENSG00000047662	ENSG00000118579	0	1107	100	1107	0	-1	3	-1/3
ENSG00000087302	ENSG00000087303	0	236	98.729	233	3	-1	3	-1/3
ENSG00000087302	ENSG00000242498	2.34e-43	63	82.54	52	11	-1	-2	-1/-2
ENSG00000151014	ENSG00000164916	9.59e-28	73	87.671	64	9	-3	-1	-3/-1
ENSG00000151014	ENSG00000171109	1.32e-27	73	87.671	64	9	-3	-2	-3/-2
ENSG00000242019	ENSG00000240403	0	123	82.114	101	22	-1	-3	-1/-3
ENSG00000174460	ENSG00000166707	0	285	86.316	246	39	1	2	1/2
ENSG00000137076	ENSG00000171914	0	394	80.457	317	77	1	3	1/3
ENSG00000180596	ENSG00000158373	6.36e-57	84	94.048	79	5	-1	-2	-1/-2
ENSG00000170917	ENSG00000138685	8.38e-139	196	98.98	194	2	-2	2	-2/2
ENSG00000140905	ENSG00000023228	3.89e-167	136	88.971	121	15	3	2	3/2
ENSG00000159251	ENSG00000143632	0	378	98.942	374	4	3	2	3/2
ENSG00000159251	ENSG00000107796	0	388	96.907	376	12	3	1	3/1
ENSG00000148943	ENSG00000104863	1.89e-100	204	82.353	168	36	1	3	1/3
ENSG00000148943	ENSG00000111052	5.32e-93	191	80.628	154	37	1	3	1/3
ENSG00000164620	ENSG00000197948	0	136	100	136	0	-2	2	-2/2
ENSG00000144566	ENSG00000108774	1.6e-122	212	87.736	186	26	3	2	3/2
ENSG00000154710	ENSG00000284461	0	878	100	878	0	-2	-3	-2/-3
ENSG00000151465	ENSG00000165609	1.78e-30	53	100	53	0	1	-2	1/-2
ENSG00000176692	ENSG00000054598	6.95e-97	122	89.344	109	13	2	1	2/1
ENSG00000146083	ENSG00000137075	4.86e-147	118	84.746	100	18	1	3	1/3
ENSG00000150593	ENSG00000214413	0	425	100	425	0	-3	2	-3/2
ENSG00000150593	ENSG00000214413	0	425	100	425	0	-2	1	-2/1
ENSG00000150593	ENSG00000214413	0	425	100	425	0	3	-3	3/-3
ENSG00000152284	ENSG00000148737	5.61e-111	98	80.612	79	19	3	1	3/1
ENSG00000172939	ENSG00000198648	0	338	83.728	283	55	1	2	1/2
ENSG00000145020	ENSG00000283189	0	388	100	388	0	-2	-3	-2/-3
ENSG00000168569	ENSG00000185475	1.84e-85	145	100	145	0	-1	1	-1/1
ENSG00000166664	ENSG00000175344	0	463	99.784	462	1	3	1	3/1
ENSG00000148136	ENSG00000204246	5.88e-176	317	83.912	266	51	1	2	1/2
ENSG00000206172	ENSG00000188536	4.91e-112	178	95.506	170	8	2	1	2/1
ENSG00000176842	ENSG00000170561	1.19e-85	97	83.505	81	16	1	3	1/3
ENSG00000142789	ENSG00000219073	2.07e-180	295	93.898	277	18	-3	-1	-3/-1
ENSG00000182793	ENSG00000243955	9.08e-143	253	84.585	214	39	-1	-2	-1/-2
ENSG00000173908	ENSG00000171446	0	331	85.196	282	49	1	3	1/3
ENSG00000173908	ENSG00000204897	0	331	84.894	281	50	1	2	1/2
ENSG00000160014	ENSG00000198668	6.41e-99	173	90.751	157	16	2	3	2/3
ENSG00000160014	ENSG00000143933	8.61e-98	153	99.346	152	1	2	3	2/3
ENSG00000181788	ENSG00000196470	6.58e-151	202	87.129	176	26	1	3	1/3
ENSG00000181788	ENSG00000196470	6.59e-151	202	87.129	176	26	1	3	1/3
ENSG00000177186	ENSG00000228198	0	313	91.693	287	26	1	2	1/2
ENSG00000121289	ENSG00000175782	9.28e-36	65	80	52	13	3	2	3/2
ENSG00000121289	ENSG00000161405	5.76e-45	67	80.597	54	13	3	-2	3/-2
ENSG00000171497	ENSG00000171503	3.16e-111	163	100	163	0	-1	3	-1/3
ENSG00000171497	ENSG00000171503	4.7e-108	163	100	163	0	2	-1	2/-1
ENSG00000171497	ENSG00000171503	2.92e-106	163	100	163	0	-2	1	-2/1
ENSG00000171497	ENSG00000171503	3.42e-92	163	100	163	0	3	-2	3/-2
ENSG00000152086	ENSG00000075886	0	288	96.181	277	11	-2	-3	-2/-3
ENSG00000152086	ENSG00000198033	0	438	98.174	430	8	3	1	3/1
ENSG00000166503	ENSG00000136404	0	312	99.359	310	2	-2	3	-2/3
ENSG00000181767	ENSG00000181693	0	351	85.755	301	50	2	3	2/3
ENSG00000177151	ENSG00000196240	0	221	100	221	0	1	2	1/2
ENSG00000179981	ENSG00000121297	0	148	85.135	126	22	3	2	3/2
ENSG00000139433	ENSG00000138035	6.46e-66	58	81.034	47	11	-3	-1	-3/-1
ENSG00000267631	ENSG00000104818	1.67e-112	169	98.817	167	2	1	2	1/2
ENSG00000267631	ENSG00000213030	1.45e-84	129	100	129	0	-2	-1	-2/-1
ENSG00000153044	ENSG00000109917	1.74e-32	50	80	40	10	2	3	2/3
ENSG00000176679	ENSG00000153779	9.46e-127	197	92.893	183	14	-1	-2	-1/-2
ENSG00000164342	ENSG00000198799	5.15e-25	53	83.019	44	9	-1	-3	-1/-3
ENSG00000170442	ENSG00000205426	0	419	99.045	415	4	2	1	2/1
ENSG00000168395	ENSG00000111653	2.28e-99	73	89.041	65	8	3	1	3/1
ENSG00000166135	ENSG00000175782	9.48e-74	91	81.319	74	17	2	3	2/3
ENSG00000166135	ENSG00000160991	1.31e-87	82	80.488	66	16	-2	1	-2/1
ENSG00000144231	ENSG00000174990	1.9e-131	90	81.111	73	17	3	-2	3/-2
ENSG00000169750	ENSG00000128340	5e-116	200	86.5	173	27	1	3	1/3
ENSG00000177103	ENSG00000171587	0	79	81.013	64	15	3	2	3/2
ENSG00000171132	ENSG00000027075	0	67	88.06	59	8	1	2	1/2
ENSG00000167088	ENSG00000198393	2.39e-66	75	80	60	15	-1	2	-1/2
ENSG00000167088	ENSG00000136213	5.05e-87	98	84.694	83	15	1	-2	1/-2
ENSG00000125944	ENSG00000135316	0	404	84.406	341	63	2	1	2/1
ENSG00000154839	ENSG00000273274	1.04e-90	91	84.615	77	14	2	1	2/1
ENSG00000170950	ENSG00000102144	0	405	87.16	353	52	1	3	1/3
ENSG00000075886	ENSG00000152086	0	330	97.576	322	8	-3	-2	-3/-2
ENSG00000075886	ENSG00000198033	0	439	99.089	435	4	3	1	3/1
ENSG00000168438	ENSG00000006638	4.34e-45	92	82.609	76	16	1	-1	1/-1
ENSG00000167977	ENSG00000180901	3.13e-106	162	83.951	136	26	3	1	3/1
ENSG00000164237	ENSG00000153721	8.69e-59	63	80.952	51	12	-2	-3	-2/-3
ENSG00000152484	ENSG00000109189	0	358	88.827	318	40	3	2	3/2
ENSG00000213413	ENSG00000121716	6.94e-150	248	95.161	236	12	1	3	1/3
ENSG00000172425	ENSG00000149582	7.34e-16	52	100	52	0	-1	-3	-1/-3
ENSG00000175279	ENSG00000251503	1.8e-94	176	100	176	0	1	3	1/3
ENSG00000170027	ENSG00000128245	4.93e-135	235	87.66	206	29	2	1	2/1
ENSG00000166947	ENSG00000166946	0	361	100	361	0	1	-3	1/-3
ENSG00000164438	ENSG00000107807	1.62e-81	143	80.42	115	28	2	3	2/3
ENSG00000128655	ENSG00000284741	0	578	100	578	0	-2	-3	-2/-3
ENSG00000152253	ENSG00000221947	6.3e-91	110	89.091	98	12	2	1	2/1
ENSG00000170689	ENSG00000180806	7.85e-51	70	82.857	58	12	1	2	1/2
ENSG00000170689	ENSG00000180806	7.85e-51	70	82.857	58	12	1	3	1/3
ENSG00000174165	ENSG00000126070	2.84e-119	58	81.034	47	11	-3	3	-3/3
ENSG00000174165	ENSG00000175782	2.02e-53	54	81.481	44	10	-3	1	-3/1
ENSG00000145736	ENSG00000183474	0	571	98.949	565	6	-2	-1	-2/-1
ENSG00000171942	ENSG00000172519	0	316	87.658	277	39	-2	-1	-2/-1
ENSG00000018610	ENSG00000159259	4.33e-42	51	80.392	41	10	-1	1	-1/1
ENSG00000213516	ENSG00000147274	0	91	89.011	81	10	-1	-3	-1/-3
ENSG00000165389	ENSG00000165633	1.92e-47	100	80	80	20	-3	3	-3/3
ENSG00000166685	ENSG00000133193	2.32e-36	67	97.015	65	2	-2	1	-2/1
ENSG00000166685	ENSG00000133193	2.32e-36	67	97.015	65	2	-2	2	-2/2
ENSG00000205362	ENSG00000125144	1.19e-35	63	84.127	53	10	-1	-2	-1/-2
ENSG00000169612	ENSG00000169609	3.42e-18	56	92.857	52	4	1	-1	1/-1
ENSG00000175311	ENSG00000153721	1.16e-95	85	80	68	17	3	-1	3/-1
ENSG00000160209	ENSG00000265491	1.26e-37	86	80.233	69	17	2	-3	2/-3
ENSG00000166147	ENSG00000138829	0	319	80.564	257	62	1	2	1/2
ENSG00000161265	ENSG00000160201	6.97e-60	50	86	43	7	1	3	1/3
ENSG00000171291	ENSG00000171295	0	353	82.153	290	63	-1	-2	-1/-2
ENSG00000171291	ENSG00000196757	0	70	81.429	57	13	-2	-1	-2/-1
ENSG00000171234	ENSG00000109181	0	558	87.455	488	70	2	1	2/1
ENSG00000171234	ENSG00000213759	0	563	85.08	479	84	2	1	2/1
ENSG00000168961	ENSG00000171916	0	322	94.72	305	17	2	1	2/1
ENSG00000145780	ENSG00000141965	0	115	83.478	96	19	2	1	2/1
ENSG00000144460	ENSG00000104643	8.39e-51	97	86.598	84	13	-2	-3	-2/-3
ENSG00000160588	ENSG00000173614	5.26e-39	92	81.522	75	17	1	-2	1/-2
ENSG00000152439	ENSG00000105136	0	410	89.756	368	42	-2	-1	-2/-1
ENSG00000167004	ENSG00000128886	3.86e-124	210	100	210	0	3	-1	3/-1
ENSG00000167769	ENSG00000137992	2.27e-30	69	85.507	59	10	2	3	2/3
ENSG00000146707	ENSG00000272391	1.11e-67	134	93.284	125	9	2	3	2/3
ENSG00000179142	ENSG00000160882	0	416	92.788	386	30	-1	-2	-1/-2
ENSG00000005022	ENSG00000169100	0	304	90.461	275	29	3	2	3/2
ENSG00000005022	ENSG00000151729	1.67e-176	299	88.963	266	33	3	1	3/1
ENSG00000165410	ENSG00000175782	2.77e-116	95	82.105	78	17	-1	3	-1/3
ENSG00000188827	ENSG00000126070	2.13e-71	57	84.211	48	9	2	-3	2/-3
ENSG00000173041	ENSG00000198039	0	207	82.126	170	37	-1	-2	-1/-2
ENSG00000164729	ENSG00000259224	0	553	93.49	517	36	3	2	3/2
ENSG00000164729	ENSG00000177710	0	380	93.684	356	24	-1	-2	-1/-2
ENSG00000170484	ENSG00000139648	0	361	86.981	314	47	1	2	1/2
ENSG00000170484	ENSG00000186049	0	361	86.427	312	49	1	3	1/3
ENSG00000164091	ENSG00000101966	5.27e-38	95	81.053	77	18	-3	-1	-3/-1
ENSG00000164091	ENSG00000101966	5.27e-38	95	81.053	77	18	-3	-1	-3/-1
ENSG00000172716	ENSG00000154760	0	62	80.645	50	12	3	2	3/2
ENSG00000176890	ENSG00000132199	1.22e-94	77	97.403	75	2	3	-3	3/-3
ENSG00000180340	ENSG00000155760	0	387	80.362	311	76	3	2	3/2
ENSG00000180340	ENSG00000157240	0	309	85.113	263	46	3	2	3/2
ENSG00000180818	ENSG00000128710	1.14e-26	58	89.655	52	6	-1	-2	-1/-2
ENSG00000180818	ENSG00000253293	1.03e-20	55	80	44	11	-1	-2	-1/-2
ENSG00000145107	ENSG00000273331	3.63e-163	218	100	218	0	-1	-3	-1/-3
ENSG00000167625	ENSG00000198393	5.31e-111	57	82.456	47	10	1	2	1/2
ENSG00000163064	ENSG00000164778	1.34e-65	125	84.8	106	19	2	1	2/1
ENSG00000166501	ENSG00000154229	0	294	87.075	256	38	2	3	2/3
ENSG00000177879	ENSG00000157823	9.06e-109	192	84.375	162	30	3	1	3/1
ENSG00000168582	ENSG00000182187	4.16e-95	86	80.233	69	17	3	1	3/1
ENSG00000146411	ENSG00000028839	0	463	100	463	0	-2	1	-2/1
ENSG00000180871	ENSG00000163464	6.52e-146	305	82.623	252	53	-3	-2	-3/-2
ENSG00000180481	ENSG00000106460	4.47e-72	109	81.651	89	20	-2	-1	-2/-1
ENSG00000174233	ENSG00000173175	0	359	82.73	297	62	3	2	3/2
ENSG00000158164	ENSG00000158427	3.66e-99	109	86.239	94	15	1	3	1/3
ENSG00000158164	ENSG00000158427	1.19e-97	109	86.239	94	15	-3	-2	-3/-2
ENSG00000168228	ENSG00000081320	5.85e-37	89	82.022	73	16	-1	-3	-1/-3
ENSG00000168228	ENSG00000167693	4.01e-24	51	80.392	41	10	2	3	2/3
ENSG00000163428	ENSG00000273274	7.24e-113	88	84.091	74	14	-2	1	-2/1
ENSG00000163428	ENSG00000140323	1.22e-110	96	81.25	78	18	1	2	1/2
ENSG00000070190	ENSG00000114999	3.47e-31	50	84	42	8	2	-2	2/-2
ENSG00000239605	ENSG00000273269	7.2e-127	185	100	185	0	-2	-3	-2/-3
ENSG00000239605	ENSG00000273269	1.59e-124	185	100	185	0	1	2	1/2
ENSG00000172468	ENSG00000169953	8.72e-135	205	98.537	202	3	-1	-2	-1/-2
ENSG00000181541	ENSG00000180660	0	386	92.746	358	28	2	1	2/1
ENSG00000090273	ENSG00000130368	1.53e-50	89	80.899	72	17	-3	-1	-3/-1
ENSG00000171017	ENSG00000171488	0	90	84.444	76	14	3	1	3/1
ENSG00000150977	ENSG00000182070	0	166	80.12	133	33	-3	2	-3/2
ENSG00000150977	ENSG00000172828	3.39e-154	163	80.982	132	31	3	2	3/2
ENSG00000167657	ENSG00000196730	2.99e-144	212	84.434	179	33	1	3	1/3
ENSG00000103335	ENSG00000154864	0	173	83.815	145	28	2	1	2/1
ENSG00000158714	ENSG00000188004	0	327	99.388	325	2	-1	2	-1/2
ENSG00000115053	ENSG00000138035	1.69e-36	68	82.353	56	12	3	2	3/2
ENSG00000048828	ENSG00000184083	0	220	80	176	44	3	1	3/1
ENSG00000163623	ENSG00000148826	6.92e-86	113	83.186	94	19	1	3	1/3
ENSG00000163497	ENSG00000151702	2.38e-51	89	87.64	78	11	1	3	1/3
ENSG00000163737	ENSG00000109272	2.59e-60	86	89.535	77	9	-2	-1	-2/-1
ENSG00000089012	ENSG00000101307	0	338	80.769	273	65	-3	-2	-3/-2
ENSG00000129480	ENSG00000163093	1.14e-66	89	94.382	84	5	2	1	2/1
ENSG00000177889	ENSG00000173598	0	395	100	395	0	2	-3	2/-3
ENSG00000204983	ENSG00000275896	1.45e-129	264	87.5	231	33	-1	-2	-1/-2
ENSG00000204983	ENSG00000010438	2.16e-126	266	84.586	225	41	-1	-2	-1/-2
ENSG00000154025	ENSG00000154016	0	494	99.595	492	2	3	-1	3/-1
ENSG00000173928	ENSG00000167112	6.07e-72	73	80.822	59	14	1	-1	1/-1
ENSG00000087995	ENSG00000165055	0	452	96.239	435	17	3	1	3/1
ENSG00000162924	ENSG00000196911	0	395	93.418	369	26	1	2	1/2
ENSG00000173281	ENSG00000231925	4.53e-84	101	81.188	82	19	2	-1	2/-1
ENSG00000172006	ENSG00000214029	1.39e-38	80	81.25	65	15	-1	2	-1/2
ENSG00000243130	ENSG00000242221	0	440	89.318	393	47	3	1	3/1
ENSG00000184716	ENSG00000140264	0	296	96.622	286	10	2	-2	2/-2
ENSG00000184716	ENSG00000242028	0	91	97.802	89	2	-2	3	-2/3
ENSG00000103942	ENSG00000152413	6.3e-101	132	81.818	108	24	2	1	2/1
ENSG00000171612	ENSG00000180979	6.93e-124	57	80.702	46	11	1	2	1/2
ENSG00000256713	ENSG00000229183	0	506	99.407	503	3	-1	-2	-1/-2
ENSG00000256713	ENSG00000229859	0	506	99.012	501	5	-1	-2	-1/-2
ENSG00000156869	ENSG00000160194	2.12e-68	67	80.597	54	13	2	-3	2/-3
ENSG00000156869	ENSG00000130827	3.59e-68	61	81.967	50	11	2	3	2/3
ENSG00000157326	ENSG00000187630	0	235	91.064	214	21	3	1	3/1
ENSG00000160339	ENSG00000085265	1.03e-162	219	84.018	184	35	2	3	2/3
ENSG00000157240	ENSG00000155760	0	133	85.714	114	19	-1	-2	-1/-2
ENSG00000157240	ENSG00000180340	0	309	85.113	263	46	2	3	2/3
ENSG00000149289	ENSG00000102053	0	258	83.333	215	43	1	2	1/2
ENSG00000149289	ENSG00000163874	1.17e-138	209	82.775	173	36	1	3	1/3
ENSG00000174437	ENSG00000196296	0	508	86.811	441	67	3	2	3/2
ENSG00000151413	ENSG00000108439	1.54e-43	93	80.645	75	18	2	-3	2/-3
ENSG00000013016	ENSG00000110047	0	532	87.03	463	69	1	3	1/3
ENSG00000243232	ENSG00000204967	0	658	100	658	0	1	3	1/3
ENSG00000243232	ENSG00000081842	0	658	100	658	0	1	3	1/3
ENSG00000062582	ENSG00000270617	4.1e-140	203	99.507	202	1	3	1	3/1
ENSG00000146802	ENSG00000082212	1.48e-86	66	80.303	53	13	-2	3	-2/3
ENSG00000177363	ENSG00000198625	1.45e-82	100	83	83	17	-1	2	-1/2
ENSG00000177363	ENSG00000198625	1.45e-82	100	83	83	17	-1	1	-1/1
ENSG00000163114	ENSG00000131828	0	376	86.436	325	51	1	2	1/2
ENSG00000112232	ENSG00000131773	6.88e-110	136	82.353	112	24	1	3	1/3
ENSG00000164902	ENSG00000100784	8.46e-117	83	83.133	69	14	-1	1	-1/1
ENSG00000164902	ENSG00000175782	3.27e-122	92	81.522	75	17	3	2	3/2
ENSG00000159556	ENSG00000016082	2.71e-174	188	81.383	153	35	2	3	2/3
ENSG00000253293	ENSG00000180818	1.01e-46	78	93.59	73	5	1	3	1/3
ENSG00000143319	ENSG00000130827	1.2e-63	95	81.053	77	18	2	-2	2/-2
ENSG00000146047	ENSG00000185130	8.32e-50	91	93.407	85	6	1	2	1/2
ENSG00000146049	ENSG00000146038	6.54e-124	199	99.497	198	1	-3	2	-3/2
ENSG00000170523	ENSG00000170442	0	410	98.293	403	7	1	2	1/2
ENSG00000152082	ENSG00000136699	2.07e-97	93	100	93	0	-2	3	-2/3
ENSG00000168374	ENSG00000143761	4.98e-98	180	81.111	146	34	2	1	2/1
ENSG00000171735	ENSG00000108509	0	163	85.276	139	24	1	2	1/2
ENSG00000010292	ENSG00000111639	3.36e-41	73	100	73	0	1	-1	1/-1
ENSG00000010292	ENSG00000111639	1.64e-40	73	100	73	0	-2	2	-2/2
ENSG00000010292	ENSG00000111639	2.86e-39	73	100	73	0	-1	1	-1/1
ENSG00000270316	ENSG00000214435	0	753	99.602	750	3	2	3	2/3
ENSG00000270316	ENSG00000166275	3.34e-93	115	99.13	114	1	1	2	1/2
ENSG00000147697	ENSG00000010404	3.01e-45	88	82.955	73	15	-2	3	-2/3
ENSG00000165494	ENSG00000148734	4.95e-44	79	81.013	64	15	-1	2	-1/2
ENSG00000171489	ENSG00000171478	6.43e-119	170	100	170	0	3	1	3/1
ENSG00000171489	ENSG00000171478	6.97e-112	170	100	170	0	1	2	1/2
ENSG00000121542	ENSG00000170088	1.22e-38	53	81.132	43	10	-3	2	-3/2
ENSG00000166529	ENSG00000166526	0	296	99.662	295	1	-3	2	-3/2
ENSG00000065665	ENSG00000058262	0	477	93.501	446	31	3	2	3/2
ENSG00000163286	ENSG00000163283	0	488	97.746	477	11	2	3	2/3
ENSG00000163286	ENSG00000163295	0	516	85.659	442	74	-1	-3	-1/-3
ENSG00000131116	ENSG00000226763	1.61e-30	69	100	69	0	1	-2	1/-2
ENSG00000131116	ENSG00000226763	1.61e-30	69	100	69	0	1	-1	1/-1
ENSG00000163126	ENSG00000213337	0	496	100	496	0	1	3	1/3
ENSG00000153443	ENSG00000185262	3.86e-33	89	91.011	81	8	1	2	1/2
ENSG00000101210	ENSG00000156508	0	226	82.301	186	40	-2	-3	-2/-3
ENSG00000178363	ENSG00000160014	5.35e-84	158	81.646	129	29	1	2	1/2
ENSG00000177462	ENSG00000177212	0	312	93.59	292	20	1	2	1/2
ENSG00000189306	ENSG00000183569	3.19e-78	128	95.312	122	6	-2	3	-2/3
ENSG00000189306	ENSG00000134830	1.02e-81	72	81.944	59	13	1	-2	1/-2
ENSG00000172969	ENSG00000205097	0	355	94.366	335	20	-2	-3	-2/-3
ENSG00000174628	ENSG00000167191	0	592	100	592	0	-2	3	-2/3
ENSG00000161202	ENSG00000004975	0	131	91.603	120	11	3	2	3/2
ENSG00000161202	ENSG00000107404	0	132	82.576	109	23	3	1	3/1
ENSG00000163322	ENSG00000163319	0	394	99.746	393	1	2	-2	2/-2
ENSG00000137364	ENSG00000101882	1.21e-62	60	81.667	49	11	2	1	2/1
ENSG00000060971	ENSG00000008226	2.85e-88	143	97.902	140	3	2	-1	2/-1
ENSG00000164976	ENSG00000142279	0	70	80	56	14	3	-3	3/-3
ENSG00000147223	ENSG00000165376	4.3e-65	121	95.041	115	6	2	-2	2/-2
ENSG00000164032	ENSG00000105968	1.85e-65	130	80.769	105	25	-1	-2	-1/-2
ENSG00000154803	ENSG00000167654	1.49e-52	58	86.207	50	8	2	-2	2/-2
ENSG00000164934	ENSG00000164933	2.13e-49	108	99.074	107	1	1	-2	1/-2
ENSG00000171150	ENSG00000180008	2.22e-124	168	84.524	142	26	2	3	2/3
ENSG00000176809	ENSG00000238083	0	1190	97.563	1161	29	2	1	2/1
ENSG00000243444	ENSG00000157654	9.04e-104	183	99.454	182	1	3	1	3/1
ENSG00000164609	ENSG00000180822	7.16e-48	58	91.379	53	5	2	1	2/1
ENSG00000171989	ENSG00000166800	0	341	82.698	282	59	2	1	2/1
ENSG00000171989	ENSG00000166800	0	341	82.698	282	59	2	3	2/3
ENSG00000114573	ENSG00000186575	1.07e-49	93	86.022	80	13	1	3	1/3
ENSG00000132334	ENSG00000132670	0	122	83.607	102	20	2	1	2/1
ENSG00000140525	ENSG00000140521	3.89e-81	153	94.118	144	9	-1	3	-1/3
ENSG00000179172	ENSG00000275774	1.19e-160	261	96.169	251	10	-1	-3	-1/-3
ENSG00000179172	ENSG00000277058	6.17e-157	261	95.019	248	13	-1	-3	-1/-3
ENSG00000101335	ENSG00000118680	3.19e-101	154	93.506	144	10	3	1	3/1
ENSG00000175077	ENSG00000198471	7.42e-100	169	89.349	151	18	-2	-1	-2/-1
ENSG00000160961	ENSG00000197937	6e-180	85	81.176	69	16	1	3	1/3
ENSG00000186049	ENSG00000139648	0	365	89.315	326	39	3	2	3/2
ENSG00000186049	ENSG00000170484	0	364	86.538	315	49	3	1	3/1
ENSG00000166800	ENSG00000171989	0	332	82.229	273	59	3	2	3/2
ENSG00000169564	ENSG00000197111	0	176	92.614	163	13	3	2	3/2
ENSG00000179615	ENSG00000179626	1.18e-141	139	82.014	114	25	1	2	1/2
ENSG00000173166	ENSG00000138443	0	1164	100	1164	0	-1	2	-1/2
ENSG00000179598	ENSG00000084444	2.96e-40	72	81.944	59	13	-3	-2	-3/-2
ENSG00000134184	ENSG00000213366	0	183	92.896	170	13	1	3	1/3
ENSG00000165819	ENSG00000092203	1.26e-50	87	91.954	80	7	-2	1	-2/1
ENSG00000165819	ENSG00000092203	1.26e-50	87	91.954	80	7	-2	3	-2/3
ENSG00000166363	ENSG00000170790	0	342	92.105	315	27	-2	-3	-2/-3
ENSG00000115073	ENSG00000138107	4.86e-160	187	85.027	159	28	-3	-1	-3/-1
ENSG00000174279	ENSG00000106038	2.01e-80	107	88.785	95	12	3	2	3/2
ENSG00000164256	ENSG00000126856	0	225	93.778	211	14	3	2	3/2
ENSG00000160469	ENSG00000174672	0	264	93.561	247	17	2	1	2/1
ENSG00000160469	ENSG00000174672	0	264	93.561	247	17	2	1	2/1
ENSG00000146574	ENSG00000169402	4.07e-88	134	100	134	0	-3	1	-3/1
ENSG00000169925	ENSG00000204256	0	115	86.087	99	16	1	3	1/3
ENSG00000128886	ENSG00000167004	2.38e-124	210	100	210	0	-1	3	-1/3
ENSG00000128886	ENSG00000140264	5.73e-87	147	93.197	137	10	-1	1	-1/1
ENSG00000239961	ENSG00000204577	1e-168	142	81.69	116	26	3	2	3/2
ENSG00000239961	ENSG00000204577	2.11e-166	142	81.69	116	26	3	2	3/2
ENSG00000169592	ENSG00000149929	2.74e-144	226	99.558	225	1	-1	2	-1/2
ENSG00000124467	ENSG00000231924	0	480	88.958	427	53	2	3	2/3
ENSG00000102034	ENSG00000120690	4.33e-90	116	86.207	100	16	3	1	3/1
ENSG00000173960	ENSG00000153721	0	79	81.013	64	15	-1	-3	-1/-3
ENSG00000221866	ENSG00000076356	0	726	81.818	594	132	2	3	2/3
ENSG00000166803	ENSG00000259316	4.9e-90	146	100	146	0	1	3	1/3
ENSG00000166803	ENSG00000259316	1.38e-86	146	100	146	0	2	1	2/1
ENSG00000166803	ENSG00000259316	1.09e-83	146	100	146	0	-3	-2	-3/-2
ENSG00000166803	ENSG00000259316	1.89e-70	146	100	146	0	-1	-3	-1/-3
ENSG00000167618	ENSG00000167613	2.75e-85	145	81.379	118	27	3	1	3/1
ENSG00000165457	ENSG00000110203	3.61e-147	212	87.736	186	26	2	3	2/3
ENSG00000170604	ENSG00000119669	9.19e-139	87	88.506	77	10	1	2	1/2
ENSG00000170604	ENSG00000168264	2.12e-81	83	87.952	73	10	1	2	1/2
ENSG00000165238	ENSG00000196632	0	242	93.388	226	16	1	2	1/2
ENSG00000160993	ENSG00000160991	8.16e-133	194	100	194	0	-1	1	-1/1
ENSG00000160993	ENSG00000160991	8.16e-133	194	100	194	0	-1	1	-1/1
ENSG00000164346	ENSG00000164347	3.46e-82	127	98.425	125	2	1	-1	1/-1
ENSG00000151240	ENSG00000160305	0	768	83.073	638	130	1	3	1/3
ENSG00000140471	ENSG00000130368	4.41e-40	60	81.667	49	11	2	-1	2/-1
ENSG00000140471	ENSG00000110723	9.41e-16	66	80.303	53	13	1	2	1/2
ENSG00000152705	ENSG00000132570	5.54e-34	69	89.855	62	7	-2	-3	-2/-3
ENSG00000165516	ENSG00000165525	0	550	99.818	549	1	2	-3	2/-3
ENSG00000174903	ENSG00000138069	2.62e-121	181	96.133	174	7	1	3	1/3
ENSG00000167721	ENSG00000167720	0	243	99.588	242	1	-2	2	-2/2
ENSG00000167721	ENSG00000167112	2.28e-74	73	80.822	59	14	1	-1	1/-1
ENSG00000149150	ENSG00000167703	0	51	82.353	42	9	3	2	3/2
ENSG00000120438	ENSG00000120437	1.15e-86	136	98.529	134	2	1	-1	1/-1
ENSG00000174839	ENSG00000169609	3.85e-80	91	85.714	78	13	3	-3	3/-3
ENSG00000164588	ENSG00000099822	0	545	85.138	464	81	2	3	2/3
ENSG00000163295	ENSG00000163286	0	508	87.992	447	61	3	2	3/2
ENSG00000163295	ENSG00000163283	0	313	88.818	278	35	-3	-1	-3/-1
ENSG00000147475	ENSG00000107566	4.64e-152	286	84.266	241	45	2	3	2/3
ENSG00000198034	ENSG00000129824	1.37e-171	265	92.83	246	19	1	2	1/2
ENSG00000198034	ENSG00000280969	2.6e-123	247	80.567	199	48	-1	-2	-1/-2
ENSG00000239697	ENSG00000248871	1.03e-87	114	100	114	0	3	2	3/2
ENSG00000180855	ENSG00000196466	0	658	86.018	566	92	-1	-2	-1/-2
ENSG00000180855	ENSG00000196466	0	658	86.018	566	92	-1	-2	-1/-2
ENSG00000173914	ENSG00000173933	0	229	94.76	217	12	3	1	3/1
ENSG00000175634	ENSG00000108443	0	362	80.939	293	69	1	2	1/2
ENSG00000175634	ENSG00000108443	0	362	80.939	293	69	1	2	1/2
ENSG00000170390	ENSG00000133083	0	126	80.952	102	24	2	3	2/3
ENSG00000186832	ENSG00000186847	0	312	88.141	275	37	3	1	3/1
ENSG00000154767	ENSG00000170860	1.8e-58	92	100	92	0	-1	3	-1/3
ENSG00000239306	ENSG00000248643	7.93e-97	143	100	143	0	2	3	2/3
ENSG00000138675	ENSG00000075643	1.15e-35	54	81.481	44	10	2	-1	2/-1
ENSG00000106948	ENSG00000130827	1.19e-39	70	81.429	57	13	-3	2	-3/2
ENSG00000120733	ENSG00000115548	0	285	82.456	235	50	3	2	3/2
ENSG00000175985	ENSG00000175782	2.06e-49	57	82.456	47	10	-2	-3	-2/-3
ENSG00000198077	ENSG00000255974	0	490	94.082	461	29	3	1	3/1
ENSG00000198077	ENSG00000197838	0	489	91.207	446	43	3	1	3/1
ENSG00000140798	ENSG00000121270	0	96	81.25	78	18	-3	-2	-3/-2
ENSG00000140798	ENSG00000121270	0	96	81.25	78	18	-3	-2	-3/-2
ENSG00000129347	ENSG00000130734	5.43e-79	113	100	113	0	-2	2	-2/2
ENSG00000129347	ENSG00000130734	2.66e-74	113	100	113	0	-3	3	-3/3
ENSG00000129347	ENSG00000130734	6.89e-74	113	100	113	0	2	-2	2/-2
ENSG00000129347	ENSG00000130734	1.65e-72	113	100	113	0	1	-1	1/-1
ENSG00000129347	ENSG00000130734	1.3e-65	113	100	113	0	3	-3	3/-3
ENSG00000174840	ENSG00000153721	1.56e-95	87	82.759	72	15	-2	1	-2/1
ENSG00000162337	ENSG00000100068	0	275	83.273	229	46	2	3	2/3
ENSG00000147883	ENSG00000147889	7.69e-64	124	86.29	107	17	3	1	3/1
ENSG00000178586	ENSG00000182083	1.08e-154	307	92.834	285	22	-1	-2	-1/-2
ENSG00000157259	ENSG00000175782	3.8e-109	87	81.609	71	16	-1	-3	-1/-3
ENSG00000157259	ENSG00000126070	5.71e-116	71	80.282	57	14	2	3	2/3
ENSG00000172869	ENSG00000104093	0	60	80	48	12	3	1	3/1
ENSG00000158417	ENSG00000135945	4.4e-180	284	100	284	0	-1	1	-1/1
ENSG00000158417	ENSG00000135945	4.4e-180	284	100	284	0	-1	3	-1/3
ENSG00000126773	ENSG00000100612	0	298	100	298	0	1	-3	1/-3
ENSG00000126773	ENSG00000100612	0	298	100	298	0	3	-2	3/-2
ENSG00000126773	ENSG00000100612	0	298	100	298	0	-1	3	-1/3
ENSG00000126773	ENSG00000100612	5.19e-180	298	100	298	0	-2	1	-2/1
ENSG00000204897	ENSG00000171446	0	269	91.45	246	23	2	3	2/3
ENSG00000204897	ENSG00000173908	0	269	85.13	229	40	2	1	2/1
ENSG00000181396	ENSG00000108219	2.29e-82	78	83.333	65	13	1	2	1/2
ENSG00000136404	ENSG00000166503	0	296	99.324	294	2	2	-2	2/-2
ENSG00000164106	ENSG00000136213	2.35e-73	53	81.132	43	10	1	-3	1/-3
ENSG00000213203	ENSG00000281887	2.58e-106	145	99.31	144	1	-1	-3	-1/-3
ENSG00000160072	ENSG00000197785	0	579	89.983	521	58	3	2	3/2
ENSG00000160072	ENSG00000197785	0	579	89.983	521	58	3	2	3/2
ENSG00000169239	ENSG00000174990	1.34e-63	90	82.222	74	16	-3	1	-3/1
ENSG00000159409	ENSG00000273025	5.99e-167	90	86.667	78	12	3	1	3/1
ENSG00000155858	ENSG00000160991	2.18e-67	72	81.944	59	13	-2	-3	-2/-3
ENSG00000155858	ENSG00000160991	2.26e-67	72	81.944	59	13	-2	-3	-2/-3
ENSG00000181789	ENSG00000158623	0	596	83.725	499	97	3	2	3/2
ENSG00000123064	ENSG00000186710	2.17e-94	125	100	125	0	-1	3	-1/3
ENSG00000160683	ENSG00000186174	0	882	100	882	0	3	-1	3/-1
ENSG00000158023	ENSG00000110801	6.94e-101	145	100	145	0	1	3	1/3
ENSG00000158023	ENSG00000110801	8.14e-99	145	100	145	0	2	1	2/1
ENSG00000158023	ENSG00000110801	1.95e-93	145	100	145	0	-1	-2	-1/-2
ENSG00000164933	ENSG00000164934	2.34e-49	108	99.074	107	1	-2	1	-2/1
ENSG00000175514	ENSG00000175544	7.39e-49	77	100	77	0	-3	2	-3/2
ENSG00000175514	ENSG00000175544	1.29e-47	77	100	77	0	1	-2	1/-2
ENSG00000283992	ENSG00000284505	2.64e-108	81	100	81	0	2	3	2/3
ENSG00000168875	ENSG00000125285	8.65e-34	77	80.519	62	15	-2	-3	-2/-3
ENSG00000168875	ENSG00000182968	2.07e-32	64	92.188	59	5	-2	-3	-2/-3
ENSG00000180708	ENSG00000173285	2.65e-86	110	86.364	95	15	-3	-1	-3/-1
ENSG00000166847	ENSG00000177225	5.35e-45	53	86.792	46	7	1	-2	1/-2
ENSG00000166847	ENSG00000177225	3.34e-44	53	86.792	46	7	-3	2	-3/2
ENSG00000172667	ENSG00000231925	5.6e-50	99	83.838	83	16	1	-1	1/-1
ENSG00000173011	ENSG00000276234	5.54e-52	52	80.769	42	10	2	3	2/3
ENSG00000173011	ENSG00000138032	4.56e-32	97	83.505	81	16	-1	-2	-1/-2
ENSG00000169469	ENSG00000169474	6.62e-45	57	92.982	53	4	1	2	1/2
ENSG00000162624	ENSG00000106852	2.41e-118	64	92.188	59	5	2	1	2/1
ENSG00000152093	ENSG00000136698	0	250	99.6	249	1	1	3	1/3
ENSG00000166794	ENSG00000157734	5.17e-92	111	100	111	0	-3	3	-3/3
ENSG00000173542	ENSG00000114978	2.3e-157	217	95.853	208	9	1	3	1/3
ENSG00000151743	ENSG00000139160	0	373	100	373	0	-2	3	-2/3
ENSG00000172476	ENSG00000102128	0	242	98.347	238	4	1	3	1/3
ENSG00000162928	ENSG00000138592	9.76e-111	100	82	82	18	-1	-2	-1/-2
ENSG00000145626	ENSG00000168671	0	389	80.206	312	77	-2	-3	-2/-3
ENSG00000167194	ENSG00000149926	5.06e-59	91	100	91	0	3	-2	3/-2
ENSG00000167194	ENSG00000149926	1.8e-58	91	100	91	0	-3	3	-3/3
ENSG00000167194	ENSG00000149926	3.13e-49	91	100	91	0	-1	1	-1/1
ENSG00000167194	ENSG00000149926	1.66e-45	91	100	91	0	-2	2	-2/2
ENSG00000167194	ENSG00000149926	5.06e-59	91	100	91	0	3	-2	3/-2
ENSG00000167194	ENSG00000149926	1.8e-58	91	100	91	0	-3	2	-3/2
ENSG00000167194	ENSG00000149926	3.13e-49	91	100	91	0	-1	3	-1/3
ENSG00000167194	ENSG00000149926	1.66e-45	91	100	91	0	-2	1	-2/1
ENSG00000213512	ENSG00000162654	0	482	82.365	397	85	2	3	2/3
ENSG00000172922	ENSG00000172977	1.1e-158	191	97.906	187	4	-1	3	-1/3
ENSG00000172922	ENSG00000172977	1.1e-158	191	97.906	187	4	-1	2	-1/2
ENSG00000156925	ENSG00000152977	7.45e-158	185	89.73	166	19	2	1	2/1
ENSG00000162972	ENSG00000162971	4.12e-49	80	100	80	0	-2	3	-2/3
ENSG00000172023	ENSG00000115386	1.41e-101	217	81.106	176	41	-1	-2	-1/-2
ENSG00000189091	ENSG00000175782	2.49e-101	91	80.22	73	18	-1	3	-1/3
ENSG00000189091	ENSG00000265491	3.24e-69	92	80.435	74	18	3	-2	3/-2
ENSG00000151615	ENSG00000152192	8.78e-105	177	85.876	152	25	3	1	3/1
ENSG00000140525	ENSG00000140521	3.92e-81	153	94.118	144	9	-1	3	-1/3
ENSG00000175548	ENSG00000139133	0	131	89.313	117	14	3	2	3/2
ENSG00000167460	ENSG00000198467	2.43e-64	80	91.25	73	7	3	1	3/1
ENSG00000102189	ENSG00000187510	0	485	100	485	0	-1	3	-1/3
ENSG00000154342	ENSG00000108379	0	344	85.465	294	50	1	2	1/2
ENSG00000178934	ENSG00000205076	1.69e-103	155	100	155	0	2	1	2/1
ENSG00000104973	ENSG00000104960	8.56e-52	52	84.615	44	8	-1	-3	-1/-3
ENSG00000104973	ENSG00000104960	8.58e-52	52	84.615	44	8	-1	-3	-1/-3
ENSG00000176014	ENSG00000258947	0	277	96.029	266	11	1	3	1/3
ENSG00000174059	ENSG00000108306	5.94e-51	60	80	48	12	2	3	2/3
ENSG00000169397	ENSG00000169385	5.91e-111	77	89.61	69	8	2	1	2/1
ENSG00000128789	ENSG00000101624	1.15e-35	85	92.941	79	6	2	-3	2/-3
ENSG00000173757	ENSG00000126561	0	686	95.19	653	33	2	1	2/1
ENSG00000189052	ENSG00000213030	7.57e-173	214	98.598	211	3	3	2	3/2
ENSG00000140632	ENSG00000163735	6.12e-114	107	81.308	87	20	1	3	1/3
ENSG00000173457	ENSG00000182541	7.83e-110	171	91.228	156	15	2	3	2/3
ENSG00000173548	ENSG00000177971	4.63e-155	128	100	128	0	1	-1	1/-1
ENSG00000172487	ENSG00000167822	5.55e-177	281	90.391	254	27	3	2	3/2
ENSG00000170743	ENSG00000134207	3.35e-163	73	82.192	60	13	1	2	1/2
ENSG00000175567	ENSG00000175564	5.42e-139	58	81.034	47	11	1	2	1/2
ENSG00000175567	ENSG00000175564	2.35e-118	58	81.034	47	11	1	3	1/3
ENSG00000170953	ENSG00000197125	8.29e-136	139	82.734	115	24	2	1	2/1
ENSG00000171320	ENSG00000204923	2.9e-58	76	97.368	74	2	-3	-1	-3/-1
ENSG00000169118	ENSG00000133275	6.41e-133	60	80	48	12	-2	-3	-2/-3
ENSG00000162066	ENSG00000205923	0	457	100	457	0	-1	2	-1/2
ENSG00000153779	ENSG00000176679	1.5e-124	197	92.893	183	14	-2	-1	-2/-1
ENSG00000145919	ENSG00000228075	2.13e-151	63	80.952	51	12	-1	-2	-1/-2
ENSG00000171469	ENSG00000171466	0	300	86.667	260	40	2	1	2/1
ENSG00000153147	ENSG00000102038	0	750	86.4	648	102	1	2	1/2
ENSG00000179388	ENSG00000122877	1.85e-81	108	88.889	96	12	2	3	2/3
ENSG00000156052	ENSG00000088256	0	315	91.111	287	28	2	3	2/3
ENSG00000213160	ENSG00000144362	4.3e-65	112	100	112	0	1	2	1/2
ENSG00000213160	ENSG00000144362	5.04e-59	112	100	112	0	2	3	2/3
ENSG00000179083	ENSG00000234545	3.21e-62	61	90.164	55	6	3	1	3/1
ENSG00000157827	ENSG00000161791	0	130	86.154	112	18	2	1	2/1
ENSG00000151746	ENSG00000185963	0	201	85.572	172	29	2	3	2/3
ENSG00000144712	ENSG00000111530	0	189	81.481	154	35	1	3	1/3
ENSG00000180016	ENSG00000127780	1.8e-162	188	92.021	173	15	-1	-2	-1/-2
ENSG00000173020	ENSG00000100077	0	685	84.088	576	109	3	1	3/1
ENSG00000167880	ENSG00000214860	0	113	92.035	104	9	3	2	3/2
ENSG00000063322	ENSG00000168067	1.21e-68	99	81.818	81	18	-2	-3	-2/-3
ENSG00000167552	ENSG00000167553	0	454	89.427	406	48	-2	-3	-2/-3
ENSG00000106246	ENSG00000248919	0	458	100	458	0	-1	-3	-1/-3
ENSG00000141551	ENSG00000213923	0	298	96.98	289	9	3	2	3/2
ENSG00000163453	ENSG00000047315	7.97e-58	91	100	91	0	3	-1	3/-1
ENSG00000163453	ENSG00000047315	2.84e-57	91	100	91	0	-1	2	-1/2
ENSG00000236761	ENSG00000244693	0	545	98.716	538	7	1	3	1/3
ENSG00000236761	ENSG00000225932	0	545	98.532	537	8	1	3	1/3
ENSG00000149657	ENSG00000257103	8.8e-77	103	85.437	88	15	2	1	2/1
ENSG00000149657	ENSG00000257103	1.02e-76	103	85.437	88	15	2	3	2/3
ENSG00000169291	ENSG00000161405	7.33e-66	50	80	40	10	2	-3	2/-3
ENSG00000113240	ENSG00000013441	0	342	87.135	298	44	2	3	2/3
ENSG00000267855	ENSG00000167774	2.86e-90	151	100	151	0	-1	-3	-1/-3
ENSG00000167996	ENSG00000167995	3.29e-146	203	99.507	202	1	-2	2	-2/2
ENSG00000126945	ENSG00000169045	0	207	85.99	178	29	-2	-3	-2/-3
ENSG00000126945	ENSG00000169045	0	207	85.99	178	29	-2	-1	-2/-1
ENSG00000168038	ENSG00000187951	3.77e-49	95	85.263	81	14	-2	-1	-2/-1
ENSG00000100934	ENSG00000101310	0	547	83.912	459	88	3	1	3/1
ENSG00000100934	ENSG00000101310	0	547	83.912	459	88	3	2	3/2
ENSG00000204414	ENSG00000213218	1.52e-111	159	91.824	146	13	3	2	3/2
ENSG00000160113	ENSG00000175745	1.31e-128	79	84.81	67	12	1	2	1/2
ENSG00000105618	ENSG00000105619	1.44e-43	73	100	73	0	-3	1	-3/1
ENSG00000105618	ENSG00000105619	1.05e-27	73	100	73	0	1	-3	1/-3
ENSG00000153976	ENSG00000125430	2.56e-180	273	95.238	260	13	1	2	1/2
ENSG00000153976	ENSG00000125430	2.56e-180	273	95.238	260	13	1	2	1/2
ENSG00000145592	ENSG00000175782	1.01e-121	70	80	56	14	2	3	2/3
ENSG00000145592	ENSG00000198393	8.87e-97	60	81.667	49	11	3	-3	3/-3
ENSG00000181610	ENSG00000153721	1.27e-56	50	80	40	10	-2	-3	-2/-3
ENSG00000181610	ENSG00000198393	4.14e-77	61	80.328	49	12	-2	-1	-2/-1
ENSG00000125375	ENSG00000100490	0	260	100	260	0	-3	3	-3/3
ENSG00000125375	ENSG00000100490	0	260	100	260	0	2	-1	2/-1
ENSG00000181761	ENSG00000181767	0	313	92.013	288	25	1	3	1/3
ENSG00000181761	ENSG00000181767	0	313	92.013	288	25	1	2	1/2
ENSG00000140015	ENSG00000143473	0	317	84.858	269	48	3	1	3/1
ENSG00000165496	ENSG00000147403	2.03e-145	223	93.722	209	14	2	3	2/3
ENSG00000165496	ENSG00000147403	2.03e-145	223	93.722	209	14	2	1	2/1
ENSG00000156802	ENSG00000119778	0	335	81.791	274	61	1	3	1/3
ENSG00000151470	ENSG00000151466	5.14e-57	97	100	97	0	-3	1	-3/1
ENSG00000151470	ENSG00000151466	5.14e-53	97	100	97	0	1	-2	1/-2
ENSG00000165526	ENSG00000197798	5.67e-38	86	96.512	83	3	-2	1	-2/1
ENSG00000154118	ENSG00000149596	2.12e-141	173	80.347	139	34	3	1	3/1
ENSG00000168904	ENSG00000136213	9.21e-98	112	83.929	94	18	-1	2	-1/2
ENSG00000170088	ENSG00000134830	7.4e-47	52	84.615	44	8	3	-1	3/-1
ENSG00000152932	ENSG00000105649	3.65e-118	194	88.66	172	22	2	3	2/3
ENSG00000152932	ENSG00000169213	1.4e-116	209	81.818	171	38	2	1	2/1
ENSG00000196705	ENSG00000160352	0	486	85.597	416	70	-3	-2	-3/-2
ENSG00000139318	ENSG00000164086	2.96e-154	199	80.402	160	39	3	2	3/2
ENSG00000255529	ENSG00000137878	0	353	99.717	352	1	3	2	3/2
ENSG00000173141	ENSG00000169609	9.67e-30	63	80.952	51	12	2	-2	2/-2
ENSG00000169249	ENSG00000090659	8.24e-115	71	80.282	57	14	-1	1	-1/1
ENSG00000170262	ENSG00000142207	3.86e-139	203	100	203	0	3	-2	3/-2
ENSG00000170262	ENSG00000142207	8.54e-129	203	100	203	0	-1	2	-1/2
ENSG00000168671	ENSG00000145626	0	85	90.588	77	8	2	3	2/3
ENSG00000159961	ENSG00000221882	2.22e-158	204	100	204	0	-3	-2	-3/-2
ENSG00000174125	ENSG00000174130	0	326	90.184	294	32	-3	-1	-3/-1
ENSG00000176953	ENSG00000126070	1.23e-94	77	80.519	62	15	-3	-1	-3/-1
ENSG00000159409	ENSG00000273025	1.14e-176	90	86.667	78	12	3	1	3/1
ENSG00000170684	ENSG00000119866	1.55e-56	50	80	40	10	3	1	3/1
ENSG00000170684	ENSG00000127152	1.86e-55	50	80	40	10	3	2	3/2
ENSG00000169918	ENSG00000264522	0	197	80.711	159	38	1	2	1/2
ENSG00000152518	ENSG00000185650	7.38e-55	74	90.541	67	7	1	2	1/2
ENSG00000152518	ENSG00000185650	7.45e-55	74	90.541	67	7	1	3	1/3
ENSG00000166441	ENSG00000138600	6.26e-41	61	80.328	49	12	-1	-3	-1/-3
ENSG00000173451	ENSG00000133858	0	320	99.688	319	1	2	-2	2/-2
ENSG00000169840	ENSG00000180613	1.11e-43	71	88.732	63	8	1	3	1/3
ENSG00000169840	ENSG00000180613	3.3e-43	71	88.732	63	8	1	3	1/3
ENSG00000182196	ENSG00000150967	3.75e-147	204	100	204	0	3	-3	3/-3
ENSG00000154917	ENSG00000175582	2.84e-127	210	90.952	191	19	3	1	3/1
ENSG00000129968	ENSG00000136379	1.27e-140	249	80.723	201	48	3	2	3/2
ENSG00000161509	ENSG00000105464	0	418	83.493	349	69	1	2	1/2
ENSG00000152580	ENSG00000144893	0	1192	100	1192	0	3	-3	3/-3
ENSG00000163254	ENSG00000182187	1.16e-98	83	95.181	79	4	3	1	3/1
ENSG00000167195	ENSG00000140478	0	338	99.704	337	1	3	2	3/2
ENSG00000167195	ENSG00000215186	0	180	98.333	177	3	-2	-3	-2/-3
ENSG00000176542	ENSG00000267534	3.23e-73	93	83.871	78	15	2	3	2/3
ENSG00000239789	ENSG00000130827	1.71e-35	62	82.258	51	11	-2	1	-2/1
ENSG00000163755	ENSG00000047457	0	411	100	411	0	-1	2	-1/2
ENSG00000166823	ENSG00000188095	2.52e-62	102	85.294	87	15	2	1	2/1
ENSG00000147536	ENSG00000215193	4.52e-36	55	80	44	11	-3	2	-3/2
ENSG00000072062	ENSG00000142875	0	345	93.043	321	24	3	1	3/1
ENSG00000171634	ENSG00000228696	8.52e-51	75	92	69	6	1	3	1/3
ENSG00000180934	ENSG00000188691	3.79e-115	59	86.441	51	8	-1	-2	-1/-2
ENSG00000126785	ENSG00000119729	4.69e-100	190	80	152	38	1	2	1/2
ENSG00000170296	ENSG00000139112	1e-66	116	87.069	101	15	3	2	3/2
ENSG00000170296	ENSG00000139112	1e-66	116	87.069	101	15	3	2	3/2
ENSG00000108556	ENSG00000205710	6.44e-177	67	100	67	0	3	-2	3/-2
ENSG00000108556	ENSG00000205710	4.21e-168	67	100	67	0	-3	1	-3/1
ENSG00000108556	ENSG00000205710	6.34e-138	67	100	67	0	-1	2	-1/2
ENSG00000145863	ENSG00000109158	0	334	83.533	279	55	2	3	2/3
ENSG00000066084	ENSG00000151240	0	152	88.816	135	17	2	1	2/1
ENSG00000066084	ENSG00000160305	0	149	89.262	133	16	2	1	2/1
ENSG00000123066	ENSG00000108510	0	57	85.965	49	8	1	3	1/3
ENSG00000065978	ENSG00000060138	6.48e-56	91	94.505	86	5	2	1	2/1
ENSG00000156269	ENSG00000102030	1.65e-115	172	91.86	158	14	3	2	3/2
ENSG00000154274	ENSG00000181826	4.32e-82	142	99.296	141	1	-2	1	-2/1
ENSG00000170486	ENSG00000139648	0	364	85.989	313	51	3	2	3/2
ENSG00000170925	ENSG00000268629	1.53e-153	168	82.738	139	29	1	2	1/2
ENSG00000255974	ENSG00000198077	0	535	91.402	489	46	1	3	1/3
ENSG00000255974	ENSG00000197838	0	323	89.783	290	33	-1	-3	-1/-3
ENSG00000170006	ENSG00000198393	9.2e-88	76	82.895	63	13	-3	3	-3/3
ENSG00000170006	ENSG00000175782	1.93e-53	78	80.769	63	15	-3	-1	-3/-1
ENSG00000171931	ENSG00000241322	0	620	98.71	612	8	3	1	3/1
ENSG00000157911	ENSG00000157916	0	292	100	292	0	2	-1	2/-1
ENSG00000043039	ENSG00000131668	9.65e-46	72	80.556	58	14	1	2	1/2
ENSG00000149968	ENSG00000166670	0	217	85.714	186	31	3	2	3/2
ENSG00000170577	ENSG00000126778	2.17e-121	174	95.977	167	7	3	1	3/1
ENSG00000164508	ENSG00000233822	9.95e-57	124	83.065	103	21	-2	3	-2/3
ENSG00000169609	ENSG00000108587	0	175	87.429	153	22	2	3	2/3
ENSG00000169609	ENSG00000144401	0	172	82.558	142	30	2	-2	2/-2
ENSG00000177842	ENSG00000198393	3.41e-170	61	83.607	51	10	3	2	3/2
ENSG00000277075	ENSG00000233822	1.9e-68	114	93.86	107	7	1	-1	1/-1
ENSG00000174749	ENSG00000112096	0	519	88.632	460	59	-2	-3	-2/-3
ENSG00000174749	ENSG00000173200	0	329	89.97	296	33	1	3	1/3
ENSG00000164615	ENSG00000163545	2.52e-43	55	85.455	47	8	-1	-2	-1/-2
ENSG00000173349	ENSG00000136709	0	692	100	692	0	3	-3	3/-3
ENSG00000169629	ENSG00000183054	0	802	99.751	800	2	1	3	1/3
ENSG00000169629	ENSG00000015568	0	946	99.683	943	3	-2	-3	-2/-3
ENSG00000149269	ENSG00000077264	0	301	90.033	271	30	3	2	3/2
ENSG00000177238	ENSG00000136213	0	94	89.362	84	10	2	1	2/1
ENSG00000177238	ENSG00000100784	0	98	84.694	83	15	2	-1	2/-1
ENSG00000146859	ENSG00000122783	2.98e-97	144	100	144	0	-3	3	-3/3
ENSG00000146859	ENSG00000122783	1.35e-95	144	100	144	0	2	-2	2/-2
ENSG00000146859	ENSG00000122783	2.17e-93	144	100	144	0	3	-3	3/-3
ENSG00000146859	ENSG00000122783	7.72e-93	144	100	144	0	-1	1	-1/1
ENSG00000146859	ENSG00000122783	2.98e-97	144	100	144	0	-3	3	-3/3
ENSG00000146859	ENSG00000122783	1.35e-95	144	100	144	0	2	-2	2/-2
ENSG00000146859	ENSG00000122783	2.17e-93	144	100	144	0	3	-3	3/-3
ENSG00000146859	ENSG00000122783	7.72e-93	144	100	144	0	-1	1	-1/1
ENSG00000151694	ENSG00000134330	0	414	100	414	0	-1	2	-1/2
ENSG00000170790	ENSG00000166363	0	338	92.012	311	27	-3	-2	-3/-2
ENSG00000180658	ENSG00000243896	0	585	99.487	582	3	-2	-3	-2/-3
ENSG00000178338	ENSG00000169131	0	439	87.927	386	53	2	1	2/1
ENSG00000169570	ENSG00000136213	2.82e-79	85	83.529	71	14	-1	-3	-1/-3
ENSG00000163093	ENSG00000169609	0	165	86.061	142	23	-2	-3	-2/-3
ENSG00000163093	ENSG00000144401	0	106	82.075	87	19	-2	2	-2/2
ENSG00000000460	ENSG00000000457	0	314	98.726	310	4	-3	3	-3/3
ENSG00000166411	ENSG00000103740	0	869	100	869	0	1	-1	1/-1
ENSG00000133392	ENSG00000133026	0	896	82.478	739	157	3	2	3/2
ENSG00000163792	ENSG00000177225	6.66e-41	66	81.818	54	12	3	-1	3/-1
ENSG00000163792	ENSG00000177225	9.23e-41	66	81.818	54	12	3	-1	3/-1
ENSG00000170832	ENSG00000129204	0	784	92.73	727	57	-2	-3	-2/-3
ENSG00000170832	ENSG00000129204	0	784	92.73	727	57	-2	-1	-2/-1
ENSG00000163933	ENSG00000162408	5.4e-46	53	81.132	43	10	3	2	3/2
ENSG00000163933	ENSG00000136213	7.08e-65	57	80.702	46	11	2	-2	2/-2
ENSG00000155760	ENSG00000180340	0	368	82.88	305	63	2	3	2/3
ENSG00000155760	ENSG00000157240	0	134	85.075	114	20	-2	-1	-2/-1
ENSG00000161082	ENSG00000101489	0	104	82.692	86	18	2	1	2/1
ENSG00000158941	ENSG00000147439	0	356	100	356	0	-1	1	-1/1
ENSG00000184492	ENSG00000170122	0	358	94.413	338	20	3	2	3/2
ENSG00000184492	ENSG00000187559	0	273	95.971	262	11	3	1	3/1
ENSG00000173273	ENSG00000107854	0	615	85.041	523	92	3	2	3/2
ENSG00000186787	ENSG00000147059	0	350	96.857	339	11	2	1	2/1
ENSG00000146066	ENSG00000048162	1.6e-49	76	100	76	0	2	-2	2/-2
ENSG00000146066	ENSG00000048162	1.37e-47	76	100	76	0	-2	1	-2/1
ENSG00000146066	ENSG00000048162	3.54e-43	76	100	76	0	-3	2	-3/2
ENSG00000177504	ENSG00000205642	4.49e-144	161	98.137	158	3	-3	-2	-3/-2
ENSG00000154945	ENSG00000105650	1.23e-49	60	80	48	12	-3	3	-3/3
ENSG00000154945	ENSG00000105650	2.02e-49	60	80	48	12	-3	3	-3/3
ENSG00000163734	ENSG00000163739	3.43e-62	77	81.818	63	14	1	2	1/2
ENSG00000163734	ENSG00000081041	3.06e-61	87	82.759	72	15	2	1	2/1
ENSG00000144560	ENSG00000197548	0	407	100	407	0	-3	3	-3/3
ENSG00000136488	ENSG00000213218	1.33e-175	179	98.324	176	3	-3	-1	-3/-1
ENSG00000136488	ENSG00000213218	9.74e-169	179	98.324	176	3	-3	-2	-3/-2
ENSG00000167165	ENSG00000241635	0	245	100	245	0	-2	-1	-2/-1
ENSG00000164898	ENSG00000269955	6.6e-58	100	95	95	5	-1	-2	-1/-2
ENSG00000164898	ENSG00000174839	2.96e-45	87	81.609	71	16	-2	1	-2/1
ENSG00000164764	ENSG00000132874	1.42e-38	52	82.692	43	9	-3	1	-3/1
ENSG00000164764	ENSG00000103707	4.32e-46	52	80.769	42	10	1	3	1/3
ENSG00000158639	ENSG00000234068	8.19e-76	136	84.559	115	21	-1	-3	-1/-3
ENSG00000156968	ENSG00000100784	0	102	81.373	83	19	-2	3	-2/3
ENSG00000175711	ENSG00000141556	2.16e-58	102	89.216	91	11	3	-2	3/-2
ENSG00000170748	ENSG00000175718	7.23e-133	95	81.053	77	18	2	1	2/1
ENSG00000170748	ENSG00000147274	9.32e-83	97	88.66	86	11	2	3	2/3
ENSG00000176020	ENSG00000173540	0	445	100	445	0	3	1	3/1
ENSG00000165495	ENSG00000160199	4.24e-92	55	80	44	11	2	1	2/1
ENSG00000087116	ENSG00000156140	0	279	86.38	241	38	1	2	1/2
ENSG00000151693	ENSG00000119185	0	736	100	736	0	-1	2	-1/2
ENSG00000154016	ENSG00000154025	0	494	99.595	492	2	-1	3	-1/3
ENSG00000173597	ENSG00000196911	0	274	90.146	247	27	-2	2	-2/2
ENSG00000173597	ENSG00000237515	1.27e-170	249	81.124	202	47	-2	-1	-2/-1
ENSG00000172689	ENSG00000140323	7.6e-61	89	80.899	72	17	2	-1	2/-1
ENSG00000172689	ENSG00000089022	3.74e-75	84	82.143	69	15	3	2	3/2
ENSG00000241635	ENSG00000240224	0	756	82.937	627	129	2	1	2/1
ENSG00000148377	ENSG00000107937	0	311	100	311	0	-2	3	-2/3
ENSG00000171236	ENSG00000231925	2.46e-76	93	81.72	76	17	2	-1	2/-1
ENSG00000197919	ENSG00000233816	1.86e-135	212	99.528	211	1	3	1	3/1
ENSG00000272617	ENSG00000258429	2.75e-126	189	98.413	186	3	1	3	1/3
ENSG00000162490	ENSG00000160991	1.24e-96	81	80.247	65	16	-1	-2	-1/-2
ENSG00000162490	ENSG00000160991	1.37e-96	81	80.247	65	16	-1	-2	-1/-2
ENSG00000163807	ENSG00000130818	2.13e-55	100	81	81	19	-2	3	-2/3
ENSG00000169230	ENSG00000213347	1.87e-136	148	100	148	0	-2	1	-2/1
ENSG00000169230	ENSG00000213347	7.4e-122	148	100	148	0	3	-1	3/-1
ENSG00000151117	ENSG00000179057	3.74e-44	86	90.698	78	8	-1	3	-1/3
ENSG00000177971	ENSG00000173548	1.11e-155	128	100	128	0	-1	1	-1/1
ENSG00000167191	ENSG00000174628	0	592	100	592	0	3	-2	3/-2
ENSG00000166343	ENSG00000176049	1.67e-35	62	85.484	53	9	-3	-2	-3/-2
ENSG00000169385	ENSG00000169397	1.1e-102	75	88	66	9	2	3	2/3
ENSG00000173898	ENSG00000115306	0	592	81.588	483	109	1	3	1/3
ENSG00000166262	ENSG00000156958	4.99e-52	104	94.231	98	6	-1	2	-1/2
ENSG00000172519	ENSG00000186723	0	318	92.767	295	23	-1	-2	-1/-2
ENSG00000170584	ENSG00000175782	9.21e-45	92	80.435	74	18	-3	3	-3/3
ENSG00000175344	ENSG00000166664	0	450	99.778	449	1	1	3	1/3
ENSG00000092871	ENSG00000005156	0	867	100	867	0	-2	1	-2/1
ENSG00000092871	ENSG00000005156	0	867	100	867	0	1	-2	1/-2
ENSG00000146463	ENSG00000163867	0	98	80.612	79	19	3	1	3/1
ENSG00000159958	ENSG00000100784	7.81e-86	95	83.158	79	16	1	-3	1/-3
ENSG00000135077	ENSG00000168067	3.24e-41	97	80.412	78	19	3	-1	3/-1
ENSG00000169618	ENSG00000169621	0	241	100	241	0	-3	-2	-3/-2
ENSG00000169618	ENSG00000101292	1.74e-152	241	84.232	203	38	-3	-2	-3/-2
ENSG00000136709	ENSG00000173349	0	692	100	692	0	-3	3	-3/3
ENSG00000156096	ENSG00000171234	0	527	83.681	441	86	-3	-1	-3/-1
ENSG00000156096	ENSG00000213759	0	514	82.879	426	88	-3	-2	-3/-2
ENSG00000174788	ENSG00000229833	1.65e-39	74	90.541	67	7	-1	3	-1/3
ENSG00000069493	ENSG00000181163	2.94e-161	122	91.803	112	10	1	2	1/2
ENSG00000173480	ENSG00000198466	0	724	95.58	692	32	-3	-1	-3/-1
ENSG00000164168	ENSG00000167196	3.85e-35	51	80.392	41	10	-1	3	-1/3
ENSG00000188092	ENSG00000117262	0	491	100	491	0	-3	-1	-3/-1
ENSG00000167395	ENSG00000151006	1.44e-89	128	100	128	0	1	-1	1/-1
ENSG00000167395	ENSG00000151006	2.17e-83	128	100	128	0	3	-3	3/-3
ENSG00000155918	ENSG00000131015	1.08e-141	235	88.936	209	26	-3	-1	-3/-1
ENSG00000144445	ENSG00000197713	0	278	100	278	0	-2	2	-2/2
ENSG00000144445	ENSG00000197713	1.77e-171	278	100	278	0	1	-2	1/-2
ENSG00000242220	ENSG00000166984	5.62e-132	169	80.473	136	33	-3	-1	-3/-1
ENSG00000242220	ENSG00000203690	1.4e-113	106	82.075	87	19	-2	-3	-2/-3
ENSG00000153922	ENSG00000173575	0	499	85.972	429	70	2	1	2/1
ENSG00000166670	ENSG00000149968	0	390	80.256	313	77	2	3	2/3
ENSG00000005075	ENSG00000168255	3.7e-68	88	98.864	87	1	-1	-3	-1/-3
ENSG00000005075	ENSG00000267645	9.25e-58	109	82.569	90	19	2	1	2/1
ENSG00000177946	ENSG00000186575	2.03e-45	56	87.5	49	7	-1	2	-1/2
ENSG00000177946	ENSG00000186575	3.99e-30	56	87.5	49	7	1	-2	1/-2
ENSG00000112210	ENSG00000112208	0	341	100	341	0	3	-2	3/-2
ENSG00000104043	ENSG00000143515	0	189	81.481	154	35	2	1	2/1
ENSG00000156675	ENSG00000169609	5.53e-57	82	80.488	66	16	3	-2	3/-2
ENSG00000168131	ENSG00000124657	7.12e-171	310	81.613	253	57	3	1	3/1
ENSG00000185015	ENSG00000169239	2.06e-129	56	85.714	48	8	3	1	3/1
ENSG00000185015	ENSG00000174990	1.61e-55	56	82.143	46	10	3	-3	3/-3
ENSG00000169548	ENSG00000275004	3.52e-125	196	81.122	159	37	1	2	1/2
ENSG00000167196	ENSG00000153721	3.71e-58	54	83.333	45	9	2	-1	2/-1
ENSG00000186532	ENSG00000155463	1.23e-96	60	83.333	50	10	3	2	3/2
ENSG00000129250	ENSG00000054523	0	372	81.183	302	70	1	2	1/2
ENSG00000166862	ENSG00000006116	9.66e-130	167	86.228	144	23	2	3	2/3
ENSG00000177551	ENSG00000171786	1.87e-16	55	98.182	54	1	1	3	1/3
ENSG00000180901	ENSG00000167977	6.85e-96	162	83.951	136	26	1	3	1/3
ENSG00000164163	ENSG00000164162	2.35e-21	67	92.537	62	5	2	-1	2/-1
ENSG00000152270	ENSG00000172572	0	100	84	84	16	3	2	3/2
ENSG00000258947	ENSG00000188229	0	273	95.971	262	11	1	2	1/2
ENSG00000103512	ENSG00000103226	0	687	99.272	682	5	1	2	1/2
ENSG00000103512	ENSG00000185164	0	712	99.438	708	4	-3	-1	-3/-1
ENSG00000179284	ENSG00000175066	1.98e-64	80	83.75	67	13	-3	1	-3/1
ENSG00000179284	ENSG00000100784	3.76e-65	80	85	68	12	3	-1	3/-1
ENSG00000283706	ENSG00000206549	0	270	100	270	0	3	1	3/1
ENSG00000169800	ENSG00000234414	0	415	99.277	412	3	2	3	2/3
ENSG00000169800	ENSG00000242875	0	415	99.518	413	2	2	3	2/3
ENSG00000159259	ENSG00000153721	2.6e-116	93	82.796	77	16	-3	-2	-3/-2
ENSG00000159259	ENSG00000126070	1.19e-69	80	81.25	65	15	-2	3	-2/3
ENSG00000016391	ENSG00000157388	0	465	100	465	0	-3	1	-3/1
ENSG00000016391	ENSG00000175782	5.1e-53	73	80.822	59	14	-1	-3	-1/-3
ENSG00000167702	ENSG00000160973	2.34e-166	263	100	263	0	1	-2	1/-2
ENSG00000167785	ENSG00000130544	0	67	86.567	58	9	2	3	2/3
ENSG00000170608	ENSG00000125798	2.95e-50	102	81.373	83	19	-3	-1	-3/-1
ENSG00000170608	ENSG00000125798	3.96e-50	102	81.373	83	19	-3	-1	-3/-1
ENSG00000248871	ENSG00000161955	0	431	98.144	423	8	-1	-2	-1/-2
ENSG00000152219	ENSG00000055332	1.33e-60	54	88.889	48	6	3	-3	3/-3
ENSG00000159387	ENSG00000113430	4.4e-56	66	96.97	64	2	1	3	1/3
ENSG00000159387	ENSG00000113430	5.9e-56	66	96.97	64	2	1	3	1/3
ENSG00000176299	ENSG00000274102	0	350	94	329	21	1	3	1/3
ENSG00000167914	ENSG00000167693	2.37e-37	94	84.043	79	15	-3	-1	-3/-1
ENSG00000106714	ENSG00000154529	0	1216	98.273	1195	21	3	1	3/1
ENSG00000106714	ENSG00000152910	0	57	80.702	46	11	2	3	2/3
ENSG00000160224	ENSG00000179761	3.41e-17	59	83.051	49	10	1	2	1/2
ENSG00000168172	ENSG00000143458	0	89	80.899	72	17	-2	3	-2/3
ENSG00000168172	ENSG00000143458	0	89	80.899	72	17	2	-3	2/-3
ENSG00000170255	ENSG00000179817	8.12e-97	56	80.357	45	11	1	2	1/2
ENSG00000170255	ENSG00000179826	4.87e-149	163	88.344	144	19	1	3	1/3
ENSG00000172345	ENSG00000172349	0	1381	100	1381	0	2	-2	2/-2
ENSG00000145284	ENSG00000151131	8.62e-81	122	86.885	106	16	-1	-3	-1/-3
ENSG00000070756	ENSG00000090621	0	442	83.258	368	74	2	3	2/3
ENSG00000070756	ENSG00000090621	0	442	83.258	368	74	2	1	2/1
ENSG00000171446	ENSG00000204897	0	269	91.45	246	23	3	2	3/2
ENSG00000171446	ENSG00000173908	0	269	85.13	229	40	3	1	3/1
ENSG00000153767	ENSG00000174165	1.04e-35	59	86.441	51	8	-1	-3	-1/-3
ENSG00000153767	ENSG00000135956	2.87e-39	75	86.667	65	10	3	-1	3/-1
ENSG00000117877	ENSG00000012061	0	227	100	227	0	1	-2	1/-2
ENSG00000168556	ENSG00000153487	2.87e-63	66	84.848	56	10	2	3	2/3
ENSG00000168556	ENSG00000153487	2.87e-52	66	84.848	56	10	2	1	2/1
ENSG00000149929	ENSG00000169592	7.4e-171	284	99.648	283	1	2	-2	2/-2
ENSG00000171478	ENSG00000171489	5.79e-119	170	100	170	0	1	3	1/3
ENSG00000171478	ENSG00000171489	6.27e-112	170	100	170	0	2	1	2/1
ENSG00000160882	ENSG00000179142	0	407	89.681	365	42	-1	-3	-1/-3
ENSG00000123427	ENSG00000037897	4.95e-40	64	100	64	0	-3	1	-3/1
ENSG00000123427	ENSG00000037897	6.79e-40	64	100	64	0	-2	3	-2/3
ENSG00000123427	ENSG00000037897	1.63e-38	64	100	64	0	3	-3	3/-3
ENSG00000159289	ENSG00000215186	0	338	98.817	334	4	2	3	2/3
ENSG00000171056	ENSG00000164736	9.32e-53	89	85.393	76	13	2	1	2/1
ENSG00000185013	ENSG00000250741	0	406	100	406	0	3	2	3/2
ENSG00000179271	ENSG00000179262	5.37e-102	152	100	152	0	1	-3	1/-3
ENSG00000163683	ENSG00000175782	1.63e-114	68	82.353	56	12	-3	2	-3/2
ENSG00000163683	ENSG00000138592	4.27e-125	61	80.328	49	12	1	2	1/2
ENSG00000164736	ENSG00000171056	2.55e-42	71	90.141	64	7	1	2	1/2
ENSG00000164736	ENSG00000203883	7.64e-42	71	90.141	64	7	1	3	1/3
ENSG00000163611	ENSG00000169118	3.84e-19	51	82.353	42	9	2	-2	2/-2
ENSG00000172058	ENSG00000205572	5.94e-136	211	100	211	0	-1	-2	-1/-2
ENSG00000173660	ENSG00000233954	8.84e-93	149	95.973	143	6	-1	-2	-1/-2
ENSG00000153201	ENSG00000153165	0	629	96.82	609	20	-2	-1	-2/-1
ENSG00000153201	ENSG00000196862	0	514	96.304	495	19	1	3	1/3
ENSG00000162989	ENSG00000120457	3.22e-25	52	80.769	42	10	2	1	2/1
ENSG00000147488	ENSG00000196132	0	103	81.553	84	19	1	2	1/2
ENSG00000147488	ENSG00000186487	0	93	87.097	81	12	1	2	1/2
ENSG00000148734	ENSG00000175782	5.74e-159	95	81.053	77	18	-2	-3	-2/-3
ENSG00000148734	ENSG00000153721	1.15e-147	71	80.282	57	14	-2	1	-2/1
ENSG00000166926	ENSG00000110077	2.2e-94	54	87.037	47	7	2	1	2/1
ENSG00000156103	ENSG00000125966	0	176	85.227	150	26	1	2	1/2
ENSG00000146707	ENSG00000188372	2.13e-126	111	98.198	109	2	-1	-3	-1/-3
ENSG00000152977	ENSG00000043355	8.04e-135	208	83.173	173	35	-2	-1	-2/-1
ENSG00000152977	ENSG00000156925	5.18e-136	186	89.785	167	19	1	2	1/2
ENSG00000168916	ENSG00000180357	3.9e-176	96	82.292	79	17	2	3	2/3
ENSG00000165462	ENSG00000109132	2.73e-59	99	84.848	84	15	2	1	2/1
ENSG00000181718	ENSG00000181698	1.01e-127	188	80.319	151	37	1	2	1/2
ENSG00000181718	ENSG00000181698	1.01e-127	188	80.319	151	37	1	2	1/2
ENSG00000165478	ENSG00000221932	0	478	100	478	0	3	-1	3/-1
ENSG00000140274	ENSG00000140254	1.48e-162	235	100	235	0	2	-1	2/-1
ENSG00000140274	ENSG00000140254	4.16e-155	235	100	235	0	-3	1	-3/1
ENSG00000108242	ENSG00000138109	0	484	81.818	396	88	2	1	2/1
ENSG00000158805	ENSG00000187741	0	173	99.422	172	1	3	-2	3/-2
ENSG00000177839	ENSG00000120324	0	669	92.377	618	51	1	3	1/3
ENSG00000177839	ENSG00000113212	1.19e-127	65	87.692	57	8	2	3	2/3
ENSG00000149313	ENSG00000182359	2.05e-59	92	100	92	0	-3	1	-3/1
ENSG00000149313	ENSG00000182359	3.3e-37	92	100	92	0	1	-3	1/-3
ENSG00000166439	ENSG00000166435	0	727	100	727	0	-3	2	-3/2
ENSG00000145936	ENSG00000215193	1.71e-74	86	80.233	69	17	1	-2	1/-2
ENSG00000170860	ENSG00000154767	1.8e-58	92	100	92	0	3	-1	3/-1
ENSG00000170860	ENSG00000111275	5.23e-49	66	84.848	56	10	3	-2	3/-2
ENSG00000181826	ENSG00000154274	2.83e-82	142	99.296	141	1	1	-2	1/-2
ENSG00000243056	ENSG00000254996	9.14e-74	130	100	130	0	1	2	1/2
ENSG00000152147	ENSG00000138592	6.64e-152	97	86.598	84	13	-1	1	-1/1
ENSG00000152147	ENSG00000215193	3.27e-131	91	82.418	75	16	1	3	1/3
ENSG00000172367	ENSG00000248712	5.33e-119	170	100	170	0	-2	3	-2/3
ENSG00000172367	ENSG00000248712	1.62e-116	170	100	170	0	3	-2	3/-2
ENSG00000171103	ENSG00000163806	2.43e-96	133	99.248	132	1	2	-1	2/-1
ENSG00000171103	ENSG00000163806	2.43e-96	133	99.248	132	1	2	-1	2/-1
ENSG00000127507	ENSG00000160961	0	451	100	451	0	2	-1	2/-1
ENSG00000057149	ENSG00000206073	0	383	91.906	352	31	2	1	2/1
ENSG00000169676	ENSG00000184845	1.34e-143	61	80.328	49	12	3	1	3/1
ENSG00000160201	ENSG00000275895	6.13e-170	208	100	208	0	3	1	3/1
ENSG00000169627	ENSG00000183336	1.39e-105	193	98.964	191	2	-1	-2	-1/-2
ENSG00000167797	ENSG00000111328	1.75e-29	61	81.967	50	11	1	3	1/3
ENSG00000159263	ENSG00000112246	0	359	86.072	309	50	2	1	2/1
ENSG00000159263	ENSG00000112246	0	359	86.072	309	50	2	3	2/3
ENSG00000168792	ENSG00000171109	2.94e-49	101	85.149	86	15	1	-3	1/-3
ENSG00000168792	ENSG00000130818	1.23e-50	100	86	86	14	2	-1	2/-1
ENSG00000165752	ENSG00000152953	3.94e-80	51	84.314	43	8	-1	-3	-1/-3
ENSG00000169446	ENSG00000198689	6.79e-39	64	100	64	0	-2	3	-2/3
ENSG00000174990	ENSG00000169239	9.84e-34	50	80	40	10	-1	3	-1/3
ENSG00000174990	ENSG00000215193	2.0700000000000001e-162	63	80.952	51	12	1	-2	1/-2
ENSG00000159231	ENSG00000159228	6.19e-105	88	88.636	78	10	-2	-1	-2/-1
ENSG00000161217	ENSG00000102230	1.39e-139	203	80.788	164	39	3	1	3/1
ENSG00000175352	ENSG00000253485	5.03e-47	98	84.694	83	15	-1	2	-1/2
ENSG00000175352	ENSG00000138600	1.53e-48	91	89.011	81	10	2	-3	2/-3
ENSG00000175175	ENSG00000108395	7.5e-57	91	100	91	0	1	-2	1/-2
ENSG00000175175	ENSG00000108395	3.97e-49	91	100	91	0	-1	2	-1/2
ENSG00000159217	ENSG00000136231	0	163	82.209	134	29	2	1	2/1
ENSG00000165416	ENSG00000175782	1.54e-148	62	80.645	50	12	2	-1	2/-1
ENSG00000151725	ENSG00000164306	1.35e-67	114	100	114	0	-3	2	-3/2
ENSG00000168505	ENSG00000164900	1.17e-69	100	90	90	10	3	1	3/1
ENSG00000144583	ENSG00000139266	2.45e-122	185	86.486	160	25	1	3	1/3
ENSG00000166946	ENSG00000166947	0	361	100	361	0	-3	1	-3/1
ENSG00000164900	ENSG00000168505	2.45e-69	108	87.037	94	14	1	3	1/3
ENSG00000156006	ENSG00000171428	5.7e-180	307	80.13	246	61	3	2	3/2
ENSG00000169871	ENSG00000003402	0	201	90.547	182	19	3	-3	3/-3
ENSG00000169871	ENSG00000175387	0	201	89.552	180	21	3	-2	3/-2
ENSG00000171295	ENSG00000197054	0	300	83.333	250	50	-1	-2	-1/-2
ENSG00000171295	ENSG00000171291	0	353	82.153	290	63	-2	-1	-2/-1
ENSG00000164855	ENSG00000198517	4.09e-178	269	100	269	0	-2	2	-2/2
ENSG00000164855	ENSG00000198517	9.82e-149	269	100	269	0	2	-1	2/-1
ENSG00000152684	ENSG00000213949	7.31e-106	158	100	158	0	-2	-3	-2/-3
ENSG00000152684	ENSG00000213949	1.27e-104	158	100	158	0	-3	-1	-3/-1
ENSG00000168906	ENSG00000115486	1.3e-126	185	100	185	0	-3	3	-3/3
ENSG00000168906	ENSG00000115486	2.66e-119	185	100	185	0	2	-3	2/-3
ENSG00000165695	ENSG00000165698	6.95e-32	75	94.667	71	4	-3	2	-3/2
ENSG00000176208	ENSG00000140323	1.37e-38	58	81.034	47	11	3	-2	3/-2
ENSG00000154122	ENSG00000169895	3.27e-27	57	80.702	46	11	3	-3	3/-3
ENSG00000162391	ENSG00000162390	9.8e-180	255	99.608	254	1	-3	1	-3/1
ENSG00000167306	ENSG00000197535	0	119	80.672	96	23	-3	-1	-3/-1
ENSG00000167306	ENSG00000197535	0	119	80.672	96	23	-3	-1	-3/-1
ENSG00000175595	ENSG00000179841	9.07e-48	67	83.582	56	11	3	-3	3/-3
ENSG00000175595	ENSG00000265491	2.72e-45	70	81.429	57	13	3	-2	3/-2
ENSG00000146352	ENSG00000177182	5.87e-176	282	84.043	237	45	1	2	1/2
ENSG00000145912	ENSG00000145916	2.49e-81	107	100	107	0	2	-3	2/-3
ENSG00000163464	ENSG00000180871	1.99e-153	292	84.589	247	45	-2	-3	-2/-3
ENSG00000157654	ENSG00000241978	0	645	100	645	0	3	1	3/1
ENSG00000169032	ENSG00000126934	0	225	92.444	208	17	1	3	1/3
ENSG00000164778	ENSG00000163064	3.11e-52	85	85.882	73	12	1	2	1/2
ENSG00000183434	ENSG00000198176	0	88	82.955	73	15	3	2	3/2
ENSG00000183434	ENSG00000198176	1.83e-162	88	82.955	73	15	1	3	1/3
ENSG00000127080	ENSG00000188312	0	446	100	446	0	-2	2	-2/2
ENSG00000127080	ENSG00000188312	0	446	100	446	0	-2	3	-2/3
ENSG00000174776	ENSG00000114204	8.74e-19	55	94.545	52	3	2	3	2/3
ENSG00000120669	ENSG00000250709	5.78e-130	201	99.502	200	1	-3	-1	-3/-1
ENSG00000163558	ENSG00000067606	0	229	85.153	195	34	3	2	3/2
ENSG00000157322	ENSG00000157335	0	686	98.688	677	9	2	1	2/1
ENSG00000145029	ENSG00000283189	0	602	100	602	0	-2	-3	-2/-3
ENSG00000151846	ENSG00000070756	0	292	88.356	258	34	-3	-2	-3/-2
ENSG00000151846	ENSG00000090621	0	393	81.425	320	73	2	3	2/3
ENSG00000170166	ENSG00000197576	8.36e-70	90	92.222	83	7	2	1	2/1
ENSG00000188612	ENSG00000177688	4.4e-127	73	87.671	64	9	-1	-2	-1/-2
ENSG00000149483	ENSG00000162144	1.84e-64	99	100	99	0	1	-3	1/-3
ENSG00000149483	ENSG00000162144	2.53e-64	99	100	99	0	-1	3	-1/3
ENSG00000149483	ENSG00000162144	8.33e-63	99	100	99	0	-2	1	-2/1
ENSG00000149483	ENSG00000162144	7.11e-61	99	100	99	0	2	-1	2/-1
ENSG00000149483	ENSG00000162144	1.34e-60	99	100	99	0	3	-2	3/-2
ENSG00000183542	ENSG00000205810	6.27e-91	110	87.273	96	14	-2	-3	-2/-3
ENSG00000183542	ENSG00000205810	1.01e-80	110	87.273	96	14	-3	-1	-3/-1
ENSG00000183542	ENSG00000205809	6.74e-77	98	86.735	85	13	-3	-1	-3/-1
ENSG00000151006	ENSG00000167395	4.21e-90	128	100	128	0	-1	1	-1/1
ENSG00000151006	ENSG00000167395	6.35e-84	128	100	128	0	-3	3	-3/3
ENSG00000144228	ENSG00000121067	0	329	85.41	281	48	2	3	2/3
ENSG00000144228	ENSG00000121067	0	329	85.41	281	48	2	3	2/3
ENSG00000173404	ENSG00000168348	9.63e-76	93	81.72	76	17	1	2	1/2
ENSG00000166246	ENSG00000103199	2.2e-134	188	100	188	0	3	-2	3/-2
ENSG00000163840	ENSG00000138592	3.36e-103	55	80	44	11	3	-1	3/-1
ENSG00000187754	ENSG00000268447	0	350	89.429	313	37	1	2	1/2
ENSG00000187754	ENSG00000165583	0	340	83.529	284	56	1	3	1/3
ENSG00000168995	ENSG00000254521	0	64	82.812	53	11	-1	-3	-1/-3
ENSG00000151665	ENSG00000119729	8.88e-144	219	100	219	0	-1	2	-1/2
ENSG00000167113	ENSG00000167112	2.45e-42	69	100	69	0	-1	1	-1/1
ENSG00000167113	ENSG00000167112	1.02e-39	69	100	69	0	1	-2	1/-2
ENSG00000139726	ENSG00000141759	3.61e-47	91	80.22	73	18	3	-2	3/-2
ENSG00000135637	ENSG00000099715	4.8e-47	85	84.706	72	13	-1	-3	-1/-3
ENSG00000135637	ENSG00000099715	4.8e-47	85	84.706	72	13	-1	-3	-1/-3
ENSG00000145337	ENSG00000163596	0	165	91.515	151	14	2	1	2/1
ENSG00000145337	ENSG00000255072	3.16e-43	72	100	72	0	2	1	2/1
ENSG00000163481	ENSG00000163482	1.19e-38	66	96.97	64	2	2	-1	2/-1
ENSG00000171786	ENSG00000177551	2.07e-13	51	100	51	0	3	2	3/2
ENSG00000171786	ENSG00000177551	2.07e-13	51	100	51	0	3	1	3/1
ENSG00000122194	ENSG00000198670	0	250	85.6	214	36	-1	-2	-1/-2
ENSG00000170390	ENSG00000133083	0	126	80.952	102	24	1	3	1/3
ENSG00000187048	ENSG00000162365	0	479	95.407	457	22	3	2	3/2
ENSG00000005513	ENSG00000125398	6.54e-83	98	85.714	84	14	2	1	2/1
ENSG00000168298	ENSG00000187837	3.83e-48	71	100	71	0	2	1	2/1
ENSG00000168298	ENSG00000184357	3.84e-35	71	95.775	68	3	2	1	2/1
ENSG00000161980	ENSG00000188033	1.36e-44	88	81.818	72	16	1	3	1/3
ENSG00000151729	ENSG00000169100	1.3e-176	303	87.789	266	37	1	2	1/2
ENSG00000151729	ENSG00000005022	6.34e-176	299	88.963	266	33	1	3	1/3
ENSG00000146731	ENSG00000132141	0	540	85	459	81	1	3	1/3
ENSG00000145022	ENSG00000198015	4.39e-27	52	80.769	42	10	1	3	1/3
ENSG00000147251	ENSG00000135905	0	114	81.579	93	21	1	3	1/3
ENSG00000037757	ENSG00000136213	3.35e-102	100	80	80	20	3	-3	3/-3
ENSG00000069329	ENSG00000141759	7.63e-49	66	84.848	56	10	1	-2	1/-2
ENSG00000179564	ENSG00000214706	6.6e-87	127	100	127	0	3	-2	3/-2
ENSG00000179564	ENSG00000214706	4.45e-86	127	100	127	0	-2	3	-2/3
ENSG00000179564	ENSG00000214706	5.2e-84	127	100	127	0	1	-3	1/-3
ENSG00000181092	ENSG00000126070	1.39e-63	51	84.314	43	8	2	-3	2/-3
ENSG00000147679	ENSG00000171815	3.27e-43	97	82.474	80	17	-2	-3	-2/-3
ENSG00000145757	ENSG00000175449	4.92e-46	54	96.296	52	2	3	-2	3/-2
ENSG00000180233	ENSG00000186187	1.01e-48	87	80.46	70	17	2	1	2/1
ENSG00000180233	ENSG00000186187	1.01e-48	87	80.46	70	17	2	1	2/1
ENSG00000170549	ENSG00000177508	2.39e-67	96	80.208	77	19	2	3	2/3
ENSG00000141084	ENSG00000010017	4.85e-138	68	89.706	61	7	-1	-2	-1/-2
ENSG00000176024	ENSG00000256087	0	67	83.582	56	11	2	1	2/1
ENSG00000166750	ENSG00000154760	4.35e-147	52	80.769	42	10	-3	-2	-3/-2
ENSG00000166855	ENSG00000176046	4.47e-86	56	82.143	46	10	-1	-3	-1/-3
ENSG00000172789	ENSG00000106004	7.76e-38	54	88.889	48	6	1	2	1/2
ENSG00000105366	ENSG00000254521	5.33e-146	70	80	56	14	-1	-3	-1/-3
ENSG00000105366	ENSG00000254521	2.11e-121	70	80	56	14	-1	-2	-1/-2
ENSG00000165434	ENSG00000101966	5.06e-72	101	82.178	83	18	-1	-2	-1/-2
ENSG00000178694	ENSG00000178700	8.84e-44	77	97.403	75	2	1	-2	1/-2
ENSG00000155428	ENSG00000178809	0	389	99.743	388	1	3	2	3/2
ENSG00000146281	ENSG00000166200	7.57e-86	132	82.576	109	23	1	3	1/3
ENSG00000146281	ENSG00000138592	4.02e-43	65	83.077	54	11	-3	1	-3/1
ENSG00000162757	ENSG00000009790	3.38e-46	92	96.739	89	3	2	-3	2/-3
ENSG00000176105	ENSG00000197122	0	456	84.211	384	72	2	1	2/1
ENSG00000105750	ENSG00000237440	1.38e-71	85	80	68	17	-1	-2	-1/-2
ENSG00000163285	ENSG00000113327	0	253	82.213	208	45	1	2	1/2
ENSG00000163285	ENSG00000113327	0	253	82.213	208	45	1	3	1/3
ENSG00000167553	ENSG00000167552	0	463	88.553	410	53	-3	-2	-3/-2
ENSG00000160714	ENSG00000140367	2.56e-169	221	86.878	192	29	3	2	3/2
ENSG00000160714	ENSG00000140367	8.07e-154	221	86.878	192	29	3	2	3/2
ENSG00000179817	ENSG00000170255	3.59e-151	196	81.122	159	37	-3	-2	-3/-2
ENSG00000135968	ENSG00000183054	0	296	89.189	264	32	-3	-1	-3/-1
ENSG00000135968	ENSG00000015568	0	296	89.189	264	32	-3	-2	-3/-2
ENSG00000171201	ENSG00000109208	4.14e-89	71	91.549	65	6	2	3	2/3
ENSG00000172780	ENSG00000261796	0	442	100	442	0	3	2	3/2
ENSG00000111196	ENSG00000162385	1.95e-96	148	98.649	146	2	2	1	2/1
ENSG00000173705	ENSG00000265491	3.47e-41	61	80.328	49	12	-1	1	-1/1
ENSG00000128394	ENSG00000243811	0	360	83.889	302	58	1	3	1/3
ENSG00000128394	ENSG00000244509	0	155	81.29	126	29	3	1	3/1
ENSG00000173110	ENSG00000204389	0	293	83.959	246	47	-1	-2	-1/-2
ENSG00000173110	ENSG00000204388	0	637	82.575	526	111	3	1	3/1
ENSG00000172404	ENSG00000105993	4.64e-70	85	87.059	74	11	1	2	1/2
ENSG00000172404	ENSG00000105993	1.23e-68	85	87.059	74	11	1	2	1/2
ENSG00000149311	ENSG00000010704	8.05e-82	96	81.25	78	18	-1	2	-1/2
ENSG00000165584	ENSG00000268447	0	342	92.398	316	26	-3	-2	-3/-2
ENSG00000165584	ENSG00000241476	0	50	96	48	2	-2	-3	-2/-3
ENSG00000010361	ENSG00000196961	4.3e-44	71	100	71	0	1	-1	1/-1
ENSG00000241186	ENSG00000159307	4.82e-42	65	83.077	54	11	-2	-3	-2/-3
ENSG00000169258	ENSG00000074276	1.34e-37	57	100	57	0	-2	3	-2/3
ENSG00000169258	ENSG00000074276	2.53e-33	57	100	57	0	1	-1	1/-1
ENSG00000163251	ENSG00000177283	0	112	86.607	97	15	3	1	3/1
ENSG00000197888	ENSG00000171234	0	318	80.503	256	62	-2	-1	-2/-1
ENSG00000163888	ENSG00000145194	2.48e-84	124	100	124	0	1	-2	1/-2
ENSG00000165525	ENSG00000165516	0	550	99.818	549	1	-3	2	-3/2
ENSG00000166398	ENSG00000177225	7.12e-48	102	82.353	84	18	2	1	2/1
ENSG00000166398	ENSG00000177225	7.12e-48	102	82.353	84	18	2	1	2/1
ENSG00000258429	ENSG00000272617	6.82e-127	189	98.413	186	3	3	1	3/1
ENSG00000146909	ENSG00000198393	2.13e-54	57	80.702	46	11	1	-2	1/-2
ENSG00000146909	ENSG00000177225	2.11e-65	70	84.286	59	11	1	-2	1/-2
ENSG00000165502	ENSG00000241343	5.16e-62	121	82.645	100	21	-3	-2	-3/-2
ENSG00000173272	ENSG00000152082	7.59e-83	85	98.824	84	1	2	3	2/3
ENSG00000161940	ENSG00000113916	4.49e-138	151	86.755	131	20	3	2	3/2
ENSG00000161940	ENSG00000113916	7.81e-138	151	86.755	131	20	3	2	3/2
ENSG00000153253	ENSG00000144285	0	458	84.716	388	70	1	2	1/2
ENSG00000181693	ENSG00000181767	0	345	85.797	296	49	2	3	2/3
ENSG00000154174	ENSG00000206535	2.65e-41	68	100	68	0	1	-1	1/-1
ENSG00000154174	ENSG00000206535	6.35e-40	68	100	68	0	-2	2	-2/2
ENSG00000154174	ENSG00000206535	9.46e-17	68	100	68	0	-3	3	-3/3
ENSG00000154174	ENSG00000206535	3.37e-16	68	100	68	0	2	-2	2/-2
ENSG00000148672	ENSG00000182890	4.75e-68	99	81.818	81	18	3	1	3/1
ENSG00000168303	ENSG00000175782	8.01e-147	52	80.769	42	10	-2	3	-2/3
ENSG00000168303	ENSG00000138592	1.43e-177	50	82	41	9	-1	3	-1/3
ENSG00000179933	ENSG00000100813	1.35e-131	213	100	213	0	-1	2	-1/2
ENSG00000180828	ENSG00000125533	9.62e-45	80	87.5	70	10	2	1	2/1
ENSG00000160202	ENSG00000276076	2.38e-98	198	96.97	192	6	-1	-3	-1/-3
ENSG00000175564	ENSG00000175567	6.82e-139	58	81.034	47	11	2	1	2/1
ENSG00000198553	ENSG00000204977	3.86e-172	274	100	274	0	1	2	1/2
ENSG00000226288	ENSG00000232268	0	367	91.826	337	30	2	3	2/3
ENSG00000164647	ENSG00000105889	0	312	88.462	276	36	-1	-2	-1/-2
ENSG00000170759	ENSG00000155980	0	267	85.393	228	39	3	2	3/2
ENSG00000170759	ENSG00000168280	0	59	81.356	48	11	-3	-1	-3/-1
ENSG00000116120	ENSG00000214128	3.61e-36	65	81.538	53	12	-1	-2	-1/-2
ENSG00000164366	ENSG00000162390	2.41e-79	53	84.906	45	8	1	-1	1/-1
ENSG00000164366	ENSG00000170088	4.29e-71	51	80.392	41	10	1	-2	1/-2
ENSG00000172489	ENSG00000181698	1.51e-149	240	87.5	210	30	1	3	1/3
ENSG00000172489	ENSG00000181698	1.51e-149	240	87.5	210	30	1	3	1/3
ENSG00000147274	ENSG00000213516	0	95	83.158	79	16	1	3	1/3
ENSG00000147274	ENSG00000213516	0	95	83.158	79	16	1	3	1/3
ENSG00000146263	ENSG00000105392	7.52e-40	68	88.235	60	8	-3	-2	-3/-2
ENSG00000146263	ENSG00000121964	5.51e-37	69	82.609	57	12	-2	2	-2/2
ENSG00000169710	ENSG00000122224	2.95e-93	77	80.519	62	15	3	1	3/1
ENSG00000279486	ENSG00000188124	1.45e-175	275	87.273	240	35	1	2	1/2
ENSG00000168872	ENSG00000157349	0	489	97.751	478	11	2	1	2/1
ENSG00000167283	ENSG00000249222	5.68e-79	130	85.385	111	19	-2	-3	-2/-3
ENSG00000166377	ENSG00000054793	0	570	82.281	469	101	3	2	3/2
ENSG00000244414	ENSG00000080910	0	172	98.256	169	3	-3	-1	-3/-1
ENSG00000244414	ENSG00000000971	1.33e-169	217	94.47	205	12	-1	-2	-1/-2
ENSG00000152767	ENSG00000102572	0	868	99.539	864	4	2	-2	2/-2
ENSG00000152767	ENSG00000102572	0	868	99.539	864	4	2	-1	2/-1
ENSG00000151692	ENSG00000060339	5.7e-18	51	80.392	41	10	3	-1	3/-1
ENSG00000163319	ENSG00000163322	0	394	99.746	393	1	-2	2	-2/2
ENSG00000176887	ENSG00000124766	6.22e-48	86	81.395	70	16	-2	-1	-2/-1
ENSG00000176887	ENSG00000177732	2.95e-51	74	83.784	62	12	2	1	2/1
ENSG00000008226	ENSG00000060971	1.28e-87	143	97.902	140	3	-1	1	-1/1
ENSG00000008226	ENSG00000060971	1.28e-87	143	97.902	140	3	-1	2	-1/2
ENSG00000198353	ENSG00000197757	2.98e-75	101	100	101	0	-3	-1	-3/-1
ENSG00000105568	ENSG00000137713	0	582	86.426	503	79	2	1	2/1
ENSG00000196778	ENSG00000181963	2.47e-172	324	83.951	272	52	-2	-1	-2/-1
ENSG00000173175	ENSG00000174233	0	317	83.281	264	53	1	3	1/3
ENSG00000168065	ENSG00000197891	1.28e-21	55	92.727	51	4	1	2	1/2
ENSG00000157895	ENSG00000135100	0	477	100	477	0	-1	3	-1/3
ENSG00000128422	ENSG00000186847	0	320	88.75	284	36	3	1	3/1
ENSG00000152495	ENSG00000183049	4.85e-60	56	80.357	45	11	-3	-2	-3/-2
ENSG00000148965	ENSG00000255071	1.78e-101	161	99.379	160	1	-2	-3	-2/-3
ENSG00000198670	ENSG00000122194	0	311	80.064	249	62	-3	-2	-3/-2
ENSG00000137817	ENSG00000151883	3.91e-85	91	84.615	77	14	1	3	1/3
ENSG00000176200	ENSG00000172742	1.17e-172	310	82.258	255	55	1	3	1/3
ENSG00000176200	ENSG00000172742	1.17e-172	310	82.258	255	55	1	3	1/3
ENSG00000147439	ENSG00000158941	0	360	100	360	0	-3	3	-3/3
ENSG00000147439	ENSG00000158941	0	360	100	360	0	2	-2	2/-2
ENSG00000251201	ENSG00000243414	0	849	100	849	0	2	3	2/3
ENSG00000188269	ENSG00000185385	0	79	84.81	67	12	-1	-3	-1/-3
ENSG00000163735	ENSG00000140632	4.35e-99	102	86.275	88	14	2	3	2/3
ENSG00000160959	ENSG00000254402	0	164	100	164	0	1	-1	1/-1
ENSG00000168348	ENSG00000173404	2.21e-82	96	82.292	79	17	2	1	2/1
ENSG00000137857	ENSG00000140279	0	321	81.308	261	60	-1	-2	-1/-2
ENSG00000244165	ENSG00000243207	0	201	100	201	0	1	3	1/3
ENSG00000178342	ENSG00000026559	1.48e-36	54	87.037	47	7	-2	-1	-2/-1
ENSG00000175305	ENSG00000164941	0	347	100	347	0	2	-1	2/-1
ENSG00000165646	ENSG00000165650	0	718	100	718	0	2	-2	2/-2
ENSG00000144840	ENSG00000138592	5.06e-38	58	81.034	47	11	2	1	2/1
ENSG00000204478	ENSG00000232423	0	257	81.712	210	47	-3	-1	-3/-1
ENSG00000166351	ENSG00000278522	0	586	95.563	560	26	2	1	2/1
ENSG00000166351	ENSG00000183206	0	536	96.455	517	19	2	1	2/1
ENSG00000174013	ENSG00000175782	1.85e-52	71	83.099	59	12	-2	2	-2/2
ENSG00000174013	ENSG00000089022	6.94e-40	71	83.099	59	12	2	-2	2/-2
ENSG00000163877	ENSG00000136213	1.39e-56	53	83.019	44	9	-1	-3	-1/-3
ENSG00000163877	ENSG00000140323	2.97e-17	50	80	40	10	2	1	2/1
ENSG00000165985	ENSG00000131094	7.5e-91	141	86.525	122	19	2	3	2/3
ENSG00000165985	ENSG00000144119	1.58e-86	132	88.636	117	15	2	3	2/3
ENSG00000168928	ENSG00000168925	5.3e-158	154	96.104	148	6	-1	-3	-1/-3
ENSG00000170276	ENSG00000254445	1.04e-130	167	100	167	0	2	3	2/3
ENSG00000170276	ENSG00000109846	3.92e-50	85	97.647	83	2	-1	3	-1/3
ENSG00000162804	ENSG00000122085	1.2e-146	146	100	146	0	-2	3	-2/3
ENSG00000162804	ENSG00000122085	1.27e-137	146	100	146	0	3	-3	3/-3
ENSG00000162804	ENSG00000122085	8.18e-121	146	100	146	0	2	-2	2/-2
ENSG00000162804	ENSG00000122085	1.2e-146	146	100	146	0	-2	3	-2/3
ENSG00000162804	ENSG00000122085	1.28e-137	146	100	146	0	3	-2	3/-2
ENSG00000162804	ENSG00000122085	8.2e-121	146	100	146	0	2	-1	2/-1
ENSG00000162076	ENSG00000059122	3.43e-34	67	85.075	57	10	-2	-3	-2/-3
ENSG00000188171	ENSG00000081665	3.82e-42	81	80.247	65	16	-1	-2	-1/-2
ENSG00000144199	ENSG00000115042	0	321	98.131	315	6	3	1	3/1
ENSG00000144677	ENSG00000144579	2.68e-108	186	80.645	150	36	3	1	3/1
ENSG00000184227	ENSG00000119673	0	475	96	456	19	-2	-3	-2/-3
ENSG00000178988	ENSG00000179010	3.09e-50	75	82.667	62	13	3	2	3/2
ENSG00000157227	ENSG00000125966	0	112	81.25	91	21	1	2	1/2
ENSG00000143365	ENSG00000069667	5.05e-143	113	83.186	94	19	1	3	1/3
ENSG00000073584	ENSG00000264058	7.42e-157	199	100	199	0	2	1	2/1
ENSG00000186897	ENSG00000165985	3.59e-87	133	82.707	110	23	1	2	1/2
ENSG00000186897	ENSG00000131094	1.1e-81	134	88.06	118	16	1	3	1/3
ENSG00000184014	ENSG00000170456	0	96	84.375	81	15	1	2	1/2
ENSG00000122483	ENSG00000117500	2.71e-60	110	99.091	109	1	-3	2	-3/2
ENSG00000150991	ENSG00000170315	4.41e-150	240	96.25	231	9	1	3	1/3
ENSG00000154856	ENSG00000145687	3.81e-48	93	81.72	76	17	-3	2	-3/2
ENSG00000188779	ENSG00000215474	1.01e-141	203	89.163	181	22	1	2	1/2
ENSG00000231192	ENSG00000233412	0	314	94.586	297	17	1	2	1/2
ENSG00000187634	ENSG00000188976	4.91e-72	124	100	124	0	2	-1	2/-1
ENSG00000185567	ENSG00000166428	3.68e-107	158	100	158	0	-1	3	-1/3
ENSG00000092054	ENSG00000133020	0	922	80.369	741	181	2	3	2/3
ENSG00000229859	ENSG00000256713	0	506	99.012	501	5	-2	-1	-2/-1
ENSG00000129965	ENSG00000167244	6.51e-166	244	97.541	238	6	1	2	1/2
ENSG00000172725	ENSG00000110880	0	417	80.096	334	83	1	2	1/2
ENSG00000185009	ENSG00000035403	0	369	100	369	0	-3	1	-3/1
ENSG00000185009	ENSG00000035403	0	369	100	369	0	1	-3	1/-3
ENSG00000185009	ENSG00000035403	0	369	100	369	0	2	-1	2/-1
ENSG00000136238	ENSG00000169750	1.36e-109	103	90.291	93	10	3	1	3/1
ENSG00000182315	ENSG00000237247	1.92e-177	257	98.444	253	4	-3	-1	-3/-1
ENSG00000182315	ENSG00000237247	1.29e-160	257	98.444	253	4	3	2	3/2
ENSG00000187942	ENSG00000142798	0	204	100	204	0	3	-3	3/-3
ENSG00000189013	ENSG00000125498	1.42e-159	105	81.905	86	19	1	3	1/3
ENSG00000182931	ENSG00000180305	7.99e-59	58	81.034	47	11	-1	-2	-1/-2
ENSG00000177613	ENSG00000101811	0	208	87.5	182	26	1	2	1/2
ENSG00000177613	ENSG00000101811	0	208	87.5	182	26	1	2	1/2
ENSG00000101448	ENSG00000172320	7.49e-111	51	82.353	42	9	-3	-2	-3/-2
ENSG00000120253	ENSG00000196705	5.12e-52	55	81.818	45	10	1	3	1/3
ENSG00000141556	ENSG00000175711	3.18e-45	106	84.906	90	16	-3	1	-3/1
ENSG00000075891	ENSG00000196092	3.23e-88	131	81.679	107	24	-2	-3	-2/-3
ENSG00000181396	ENSG00000169660	1.02e-18	55	100	55	0	1	-2	1/-2
ENSG00000163817	ENSG00000170088	6.28e-130	73	83.562	61	12	2	-1	2/-1
ENSG00000183496	ENSG00000176624	1.51e-129	192	87.5	168	24	2	1	2/1
ENSG00000183496	ENSG00000181588	3.51e-121	193	85.492	165	28	2	1	2/1
ENSG00000187010	ENSG00000188672	0	276	91.667	253	23	-1	-3	-1/-3
ENSG00000140839	ENSG00000157322	0	444	98.649	438	6	3	2	3/2
ENSG00000178035	ENSG00000106348	0	516	83.915	433	83	2	1	2/1
ENSG00000178035	ENSG00000106348	0	516	83.915	433	83	2	1	2/1
ENSG00000162594	ENSG00000213853	1.47e-47	99	81.818	81	18	3	-2	3/-2
ENSG00000165246	ENSG00000146938	0	847	97.166	823	24	1	2	1/2
ENSG00000075624	ENSG00000184009	0	388	96.649	375	13	1	2	1/2
ENSG00000137075	ENSG00000146083	2.01e-136	118	84.746	100	18	3	1	3/1
ENSG00000174928	ENSG00000175782	5.44e-37	56	82.143	46	10	2	3	2/3
ENSG00000228049	ENSG00000267645	1.02e-71	116	100	116	0	-1	-2	-1/-2
ENSG00000184162	ENSG00000064490	2e-46	74	100	74	0	1	-2	1/-2
ENSG00000184162	ENSG00000064490	1.71e-44	74	100	74	0	-1	3	-1/3
ENSG00000184162	ENSG00000064490	6.09e-44	74	100	74	0	-2	1	-2/1
ENSG00000162654	ENSG00000213512	0	482	82.365	397	85	3	2	3/2
ENSG00000117036	ENSG00000253831	5.38e-72	125	85.6	107	18	2	1	2/1
ENSG00000140835	ENSG00000183196	1.57e-119	72	81.944	59	13	2	1	2/1
ENSG00000089050	ENSG00000169895	2.51e-39	60	81.667	49	11	1	2	1/2
ENSG00000089050	ENSG00000148734	7.61e-24	62	80.645	50	12	-1	2	-1/2
ENSG00000189132	ENSG00000185448	0	242	80.579	195	47	-3	-1	-3/-1
ENSG00000189132	ENSG00000198173	0	175	81.143	142	33	2	1	2/1
ENSG00000182287	ENSG00000106367	1.65e-88	154	87.662	135	19	2	3	2/3
ENSG00000186187	ENSG00000180233	1.36e-48	87	80.46	70	17	1	2	1/2
ENSG00000178860	ENSG00000118526	1.18e-46	104	84.615	88	16	3	1	3/1
ENSG00000180815	ENSG00000197442	0	172	81.977	141	31	1	2	1/2
ENSG00000122565	ENSG00000108468	6.56e-60	68	85.294	58	10	3	2	3/2
ENSG00000114374	ENSG00000124486	0	473	88.795	420	53	-3	-1	-3/-1
ENSG00000105708	ENSG00000242852	0	67	82.09	55	12	-1	-3	-1/-3
ENSG00000186335	ENSG00000123643	3.33e-129	56	92.857	52	4	-2	-3	-2/-3
ENSG00000186335	ENSG00000123643	3.3e-129	56	92.857	52	4	-2	-1	-2/-1
ENSG00000196981	ENSG00000196363	0	301	89.369	269	32	2	1	2/1
ENSG00000215790	ENSG00000189339	0	282	99.291	280	2	-1	-3	-1/-3
ENSG00000128591	ENSG00000136068	0	251	86.853	218	33	3	1	3/1
ENSG00000134317	ENSG00000083307	0	53	92.453	49	4	2	1	2/1
ENSG00000134317	ENSG00000083307	1.86e-180	53	92.453	49	4	2	3	2/3
ENSG00000105379	ENSG00000173200	3.13e-150	284	81.69	232	52	-2	-3	-2/-3
ENSG00000105379	ENSG00000174749	1.22e-174	197	92.386	182	15	-1	-2	-1/-2
ENSG00000126337	ENSG00000197079	0	336	81.845	275	61	1	2	1/2
ENSG00000157734	ENSG00000166794	8.98e-115	111	100	111	0	-1	3	-1/3
ENSG00000157734	ENSG00000166794	9.44e-94	111	100	111	0	3	-3	3/-3
ENSG00000205358	ENSG00000125144	4.16e-53	99	84.848	84	15	-1	-3	-1/-3
ENSG00000188313	ENSG00000163746	3.11e-118	112	84.821	95	17	1	3	1/3
ENSG00000213218	ENSG00000136487	0	293	83.618	245	48	-2	-3	-2/-3
ENSG00000177508	ENSG00000170549	2.16e-63	88	85.227	75	13	3	2	3/2
ENSG00000177508	ENSG00000176842	1.51e-45	82	82.927	68	14	3	1	3/1
ENSG00000241119	ENSG00000242366	0	778	96.53	751	27	2	1	2/1
ENSG00000241119	ENSG00000244122	0	777	95.495	742	35	2	1	2/1
ENSG00000169598	ENSG00000180488	4.92e-71	63	84.127	53	10	-2	2	-2/2
ENSG00000243772	ENSG00000240403	0	414	82.85	343	71	3	2	3/2
ENSG00000243772	ENSG00000167633	0	377	86.472	326	51	3	2	3/2
ENSG00000161791	ENSG00000157827	0	391	82.353	322	69	1	2	1/2
ENSG00000171314	ENSG00000226784	2.7e-157	255	95.686	244	11	2	1	2/1
ENSG00000173611	ENSG00000175782	1.44e-132	89	82.022	73	16	1	-1	1/-1
ENSG00000183196	ENSG00000135702	0	231	86.147	199	32	-3	-1	-3/-1
ENSG00000182810	ENSG00000167264	1.56e-75	119	100	119	0	2	-1	2/-1
ENSG00000183476	ENSG00000136425	5.76e-65	101	100	101	0	2	-1	2/-1
ENSG00000183476	ENSG00000136425	1.09e-64	101	100	101	0	3	-2	3/-2
ENSG00000183476	ENSG00000136425	1.9e-63	101	100	101	0	-1	2	-1/2
ENSG00000183476	ENSG00000136425	4.54e-62	101	100	101	0	-2	3	-2/3
ENSG00000108242	ENSG00000165841	0	231	81.818	189	42	1	2	1/2
ENSG00000181625	ENSG00000132207	0	244	100	244	0	1	2	1/2
ENSG00000183569	ENSG00000189306	3.31e-91	132	90.152	119	13	1	-3	1/-3
ENSG00000179412	ENSG00000277058	0	223	99.552	222	1	-3	-2	-3/-2
ENSG00000179412	ENSG00000275774	2.27e-167	223	93.722	209	14	-3	-2	-3/-2
ENSG00000183709	ENSG00000197110	6.43e-117	183	95.082	174	9	2	1	2/1
ENSG00000166435	ENSG00000166439	0	727	100	727	0	2	-3	2/-3
ENSG00000183426	ENSG00000224712	0	351	99.43	349	2	-2	-1	-2/-1
ENSG00000183426	ENSG00000254852	0	351	99.145	348	3	-2	-1	-2/-1
ENSG00000187372	ENSG00000120322	0	325	96.308	313	12	3	1	3/1
ENSG00000187372	ENSG00000113205	0	298	90.94	271	27	2	1	2/1
ENSG00000106244	ENSG00000180616	1.39e-41	55	83.636	46	9	-3	-1	-3/-1
ENSG00000106244	ENSG00000161714	6.63e-41	54	83.333	45	9	-3	2	-3/2
ENSG00000106244	ENSG00000161714	5.56e-32	54	83.333	45	9	2	-3	2/-3
ENSG00000219073	ENSG00000142789	4.03e-166	261	90.421	236	25	-3	-2	-3/-2
ENSG00000173917	ENSG00000105996	1.26e-57	67	88.06	59	8	1	3	1/3
ENSG00000070808	ENSG00000058404	0	476	85.714	408	68	1	2	1/2
ENSG00000143811	ENSG00000183010	8.52e-159	203	86.7	176	27	3	1	3/1
ENSG00000188095	ENSG00000166823	6.42e-60	97	88.66	86	11	1	2	1/2
ENSG00000239839	ENSG00000240247	1.09e-83	121	98.347	119	2	1	3	1/3
ENSG00000239839	ENSG00000206047	2.23e-91	118	99.153	117	1	-2	-1	-2/-1
ENSG00000108515	ENSG00000111674	0	436	83.257	363	73	1	3	1/3
ENSG00000197933	ENSG00000198342	0	505	80.792	408	97	2	1	2/1
ENSG00000240654	ENSG00000205863	0	226	95.133	215	11	2	3	2/3
ENSG00000179698	ENSG00000101882	3.87e-51	90	81.111	73	17	-2	-1	-2/-1
ENSG00000179698	ENSG00000185561	7.55e-58	97	81.443	79	18	-3	1	-3/1
ENSG00000185088	ENSG00000215193	0	98	81.633	80	18	2	-2	2/-2
ENSG00000185088	ENSG00000100784	5.44e-161	96	81.25	78	18	2	-1	2/-1
ENSG00000179520	ENSG00000091664	0	255	80.784	206	49	2	3	2/3
ENSG00000162105	ENSG00000161681	5.07e-118	105	86.667	91	14	1	2	1/2
ENSG00000137267	ENSG00000137285	0	225	100	225	0	-1	-3	-1/-3
ENSG00000184814	ENSG00000233701	2.8e-119	102	84.314	86	16	2	3	2/3
ENSG00000184814	ENSG00000206260	2.19e-121	141	88.652	125	16	-3	-1	-3/-1
ENSG00000142794	ENSG00000162825	0	393	85.751	337	56	-3	-1	-3/-1
ENSG00000186509	ENSG00000186513	3.06e-93	100	80	80	20	-2	-1	-2/-1
ENSG00000186790	ENSG00000178919	4.07e-21	58	81.034	47	11	-2	-1	-2/-1
ENSG00000128250	ENSG00000128253	0	407	91.646	373	34	1	3	1/3
ENSG00000128250	ENSG00000128276	0	366	89.617	328	38	2	1	2/1
ENSG00000172375	ENSG00000172269	6.67e-89	122	99.18	121	1	3	-3	3/-3
ENSG00000187446	ENSG00000167112	9.65e-85	89	82.022	73	16	1	3	1/3
ENSG00000187446	ENSG00000168243	1.65e-84	76	85.526	65	11	-1	-3	-1/-3
ENSG00000196911	ENSG00000025800	0	308	92.532	285	23	2	1	2/1
ENSG00000163806	ENSG00000171103	4.27e-99	132	100	132	0	1	-2	1/-2
ENSG00000163806	ENSG00000171103	1.59e-95	132	100	132	0	-3	1	-3/1
ENSG00000135111	ENSG00000121068	6.14e-168	239	87.448	209	30	2	3	2/3
ENSG00000115306	ENSG00000173898	0	428	87.383	374	54	2	3	2/3
ENSG00000130024	ENSG00000185127	4.09e-39	64	96.875	62	2	3	-1	3/-1
ENSG00000167100	ENSG00000005882	0	644	100	644	0	3	-1	3/-1
ENSG00000197226	ENSG00000109436	0	129	82.946	107	22	3	1	3/1
ENSG00000072310	ENSG00000198911	4.13e-156	56	82.143	46	10	3	2	3/2
ENSG00000277224	ENSG00000180596	1.03e-57	92	100	92	0	1	2	1/2
ENSG00000277224	ENSG00000158373	8.25e-61	81	93.827	76	5	-1	-3	-1/-3
ENSG00000183798	ENSG00000132793	2.09e-88	145	100	145	0	-1	2	-1/2
ENSG00000183798	ENSG00000132793	2.26e-85	145	100	145	0	2	-1	2/-1
ENSG00000165633	ENSG00000147853	9.11e-45	54	83.333	45	9	3	1	3/1
ENSG00000185127	ENSG00000130024	6.54e-39	64	96.875	62	2	-1	2	-1/2
ENSG00000185127	ENSG00000130024	6.54e-39	64	96.875	62	2	-1	3	-1/3
ENSG00000165246	ENSG00000146938	0	847	97.166	823	24	1	2	1/2
ENSG00000198168	ENSG00000101966	6.26e-48	81	80.247	65	16	3	-2	3/-2
ENSG00000198168	ENSG00000101966	6.26e-48	81	80.247	65	16	3	-3	3/-3
ENSG00000213934	ENSG00000196565	3.81e-125	196	97.959	192	4	3	1	3/1
ENSG00000092820	ENSG00000137710	0	331	85.498	283	48	3	2	3/2
ENSG00000177182	ENSG00000198363	0	363	100	363	0	3	-1	3/-1
ENSG00000204414	ENSG00000136488	8.58e-113	194	94.845	184	10	3	1	3/1
ENSG00000185775	ENSG00000204849	0	459	98.039	450	9	-2	-1	-2/-1
ENSG00000185775	ENSG00000275969	0	459	97.168	446	13	-2	-1	-2/-1
ENSG00000187837	ENSG00000168298	1.94e-37	87	96.552	84	3	1	2	1/2
ENSG00000140950	ENSG00000175782	3.69e-67	89	83.146	74	15	2	3	2/3
ENSG00000183840	ENSG00000150551	0	319	100	319	0	-1	2	-1/2
ENSG00000027075	ENSG00000171132	0	67	88.06	59	8	2	1	2/1
ENSG00000105438	ENSG00000136240	1.53e-108	184	84.239	155	29	1	3	1/3
ENSG00000089057	ENSG00000170482	0	92	82.609	76	16	1	3	1/3
ENSG00000259384	ENSG00000136487	3.49e-156	266	93.233	248	18	2	3	2/3
ENSG00000140526	ENSG00000101558	2.03e-162	121	86.777	105	16	-1	1	-1/1
ENSG00000181963	ENSG00000196778	1.17e-170	321	90.654	291	30	1	2	1/2
ENSG00000181963	ENSG00000196778	1.17e-170	321	90.654	291	30	1	2	1/2
ENSG00000175029	ENSG00000019995	0	622	100	622	0	2	-2	2/-2
ENSG00000175029	ENSG00000019995	0	622	100	622	0	-3	1	-3/1
ENSG00000175029	ENSG00000019995	0	622	100	622	0	1	-1	1/-1
ENSG00000162624	ENSG00000106852	1.75e-118	64	92.188	59	5	2	1	2/1
ENSG00000214929	ENSG00000186788	0	820	91.951	754	66	-1	-3	-1/-3
ENSG00000214929	ENSG00000189357	0	820	91.951	754	66	-1	-2	-1/-2
ENSG00000183389	ENSG00000188691	5.14e-150	238	81.092	193	45	-1	-2	-1/-2
ENSG00000179468	ENSG00000258083	1.02e-121	94	82.979	78	16	1	2	1/2
ENSG00000179468	ENSG00000258083	1.02e-121	94	82.979	78	16	1	3	1/3
ENSG00000214113	ENSG00000138592	2.59e-60	57	80.702	46	11	2	1	2/1
ENSG00000214113	ENSG00000138592	1.12e-54	57	80.702	46	11	-3	1	-3/1
ENSG00000214113	ENSG00000138592	6.44e-50	57	80.702	46	11	1	-2	1/-2
ENSG00000214113	ENSG00000138592	1.27e-46	57	80.702	46	11	2	-2	2/-2
ENSG00000214113	ENSG00000138592	1.73e-40	57	80.702	46	11	-3	2	-3/2
ENSG00000181467	ENSG00000125249	7.56e-98	184	90.761	167	17	2	1	2/1
ENSG00000163795	ENSG00000115234	7.7e-68	101	100	101	0	1	-1	1/-1
ENSG00000163795	ENSG00000115234	3.21e-65	101	100	101	0	-1	1	-1/1
ENSG00000184260	ENSG00000272196	2.95e-62	102	100	102	0	1	3	1/3
ENSG00000184260	ENSG00000203812	2.95e-62	102	100	102	0	1	3	1/3
ENSG00000185019	ENSG00000265491	9.8e-76	79	81.013	64	15	-2	3	-2/3
ENSG00000186119	ENSG00000205029	3.26e-148	304	81.25	247	57	3	1	3/1
ENSG00000151650	ENSG00000175387	3.51e-46	94	81.915	77	17	2	-2	2/-2
ENSG00000176244	ENSG00000122484	4.19e-82	56	80.357	45	11	1	2	1/2
ENSG00000205426	ENSG00000170442	0	455	96.484	439	16	1	2	1/2
ENSG00000010404	ENSG00000128928	3.77e-74	97	82.474	80	17	-3	-2	-3/-2
ENSG00000188100	ENSG00000276430	9.27e-62	53	94.34	50	3	1	2	1/2
ENSG00000183888	ENSG00000015153	7.14e-64	70	80	56	14	-2	1	-2/1
ENSG00000162999	ENSG00000153721	2.12e-105	60	81.667	49	11	-2	-1	-2/-1
ENSG00000184408	ENSG00000171385	0	236	81.356	192	44	-3	-2	-3/-2
ENSG00000177425	ENSG00000161405	9.68e-53	67	88.06	59	8	2	3	2/3
ENSG00000232382	ENSG00000231861	0	319	89.969	287	32	-2	-3	-2/-3
ENSG00000214595	ENSG00000100722	0	53	83.019	44	9	2	-1	2/-1
ENSG00000188735	ENSG00000139725	0	295	99.322	293	2	2	-2	2/-2
ENSG00000134438	ENSG00000173976	5.53e-41	73	89.041	65	8	2	1	2/1
ENSG00000104177	ENSG00000188467	0	222	97.297	216	6	1	-2	1/-2
ENSG00000180357	ENSG00000168916	0	95	82.105	78	17	3	2	3/2
ENSG00000119919	ENSG00000183072	3.72e-36	62	90.323	56	6	2	1	2/1
ENSG00000139714	ENSG00000215193	2.98e-29	58	82.759	48	10	-1	3	-1/3
ENSG00000198517	ENSG00000164855	2.15e-178	269	100	269	0	2	-2	2/-2
ENSG00000198517	ENSG00000164855	5.17e-149	269	100	269	0	-1	2	-1/2
ENSG00000284609	ENSG00000284680	0	314	96.815	304	10	-1	-3	-1/-3
ENSG00000176422	ENSG00000135423	0	234	100	234	0	-1	1	-1/1
ENSG00000176422	ENSG00000135423	0	234	100	234	0	3	-1	3/-1
ENSG00000176422	ENSG00000135423	0	234	100	234	0	-2	2	-2/2
ENSG00000176422	ENSG00000135423	0	234	100	234	0	-1	1	-1/1
ENSG00000176422	ENSG00000135423	0	234	100	234	0	3	-1	3/-1
ENSG00000176422	ENSG00000135423	0	234	100	234	0	-2	2	-2/2
ENSG00000117013	ENSG00000185760	0	164	90.244	148	16	2	1	2/1
ENSG00000117013	ENSG00000185760	0	164	90.244	148	16	2	3	2/3
ENSG00000185129	ENSG00000146676	2.49e-105	81	85.185	69	12	3	2	3/2
ENSG00000188076	ENSG00000268320	2.32e-81	143	97.203	139	4	-1	-3	-1/-3
ENSG00000189253	ENSG00000204450	0	556	98.561	548	8	1	3	1/3
ENSG00000189253	ENSG00000214891	0	314	88.854	279	35	-2	-1	-2/-1
ENSG00000170260	ENSG00000204946	2.22e-78	79	81.013	64	15	3	2	3/2
ENSG00000089041	ENSG00000175782	6.55e-107	96	80.208	77	19	3	1	3/1
ENSG00000089041	ENSG00000076067	1.39e-110	97	84.536	82	15	-3	2	-3/2
ENSG00000178184	ENSG00000102981	1.38e-95	133	83.459	111	22	1	3	1/3
ENSG00000149346	ENSG00000273559	4.28e-40	54	85.185	46	8	3	-1	3/-1
ENSG00000114030	ENSG00000196911	0	458	84.279	386	72	1	2	1/2
ENSG00000205420	ENSG00000185479	0	226	91.15	206	20	-1	-3	-1/-3
ENSG00000188112	ENSG00000164902	4.23e-40	64	81.25	52	12	-1	-2	-1/-2
ENSG00000203883	ENSG00000164736	1.14e-42	74	86.486	64	10	3	1	3/1
ENSG00000203883	ENSG00000171056	5.37e-34	70	80	56	14	3	2	3/2
ENSG00000119616	ENSG00000177238	9.37e-147	112	80.357	90	22	-1	3	-1/3
ENSG00000181991	ENSG00000198393	5.62e-33	55	81.818	45	10	1	-2	1/-2
ENSG00000183791	ENSG00000274744	0	497	99.396	494	3	1	2	1/2
ENSG00000183791	ENSG00000206181	0	258	80.62	208	50	3	1	3/1
ENSG00000100027	ENSG00000100023	0	569	100	569	0	-2	2	-2/2
ENSG00000136925	ENSG00000136842	0	555	100	555	0	3	-1	3/-1
ENSG00000188846	ENSG00000100784	4.45e-117	90	80	72	18	1	-1	1/-1
ENSG00000164068	ENSG00000173540	4.59e-120	119	97.479	116	3	3	-2	3/-2
ENSG00000164068	ENSG00000173540	3.14e-119	119	97.479	116	3	3	-1	3/-1
ENSG00000072422	ENSG00000008853	0	142	92.254	131	11	3	2	3/2
ENSG00000156675	ENSG00000169609	1.35e-56	82	80.488	66	16	2	-2	2/-2
ENSG00000184110	ENSG00000205609	0	678	100	678	0	1	3	1/3
ENSG00000186174	ENSG00000160683	0	882	100	882	0	-1	3	-1/3
ENSG00000116783	ENSG00000259030	0	717	99.861	716	1	1	3	1/3
ENSG00000182890	ENSG00000148672	6.35e-48	99	81.818	81	18	1	3	1/3
ENSG00000156976	ENSG00000161960	0	331	89.124	295	36	2	3	2/3
ENSG00000162390	ENSG00000162391	1.55e-179	255	99.608	254	1	1	-3	1/-3
ENSG00000185448	ENSG00000189132	0	156	83.333	130	26	-2	-1	-2/-1
ENSG00000185448	ENSG00000198173	0	174	82.759	144	30	3	2	3/2
ENSG00000183281	ENSG00000125551	0	388	99.742	387	1	1	2	1/2
ENSG00000183281	ENSG00000122194	0	179	88.827	159	20	-3	-2	-3/-2
ENSG00000099942	ENSG00000167193	2.96e-96	52	84.615	44	8	3	1	3/1
ENSG00000198271	ENSG00000213416	1.13e-57	55	90.909	50	5	-1	-3	-1/-3
ENSG00000198271	ENSG00000212722	2.03e-55	54	94.444	51	3	-1	-2	-1/-2
ENSG00000175868	ENSG00000110680	2.15e-72	76	89.474	68	8	-1	-3	-1/-3
ENSG00000183305	ENSG00000268606	0	463	100	463	0	-3	-1	-3/-1
ENSG00000184394	ENSG00000176294	7.19e-159	306	84.641	259	47	1	2	1/2
ENSG00000183960	ENSG00000089558	0	224	81.696	183	41	3	2	3/2
ENSG00000160194	ENSG00000153721	0	94	80.851	76	18	-1	2	-1/2
ENSG00000160194	ENSG00000265491	1.32e-103	81	87.654	71	10	2	3	2/3
ENSG00000186710	ENSG00000123064	8.45e-94	130	100	130	0	3	-1	3/-1
ENSG00000197616	ENSG00000006788	0	631	81.458	514	117	1	3	1/3
ENSG00000080824	ENSG00000096384	0	256	88.281	226	30	1	3	1/3
ENSG00000082175	ENSG00000169083	1.64e-133	73	80.822	59	14	3	2	3/2
ENSG00000161955	ENSG00000248871	0	431	98.144	423	8	-2	-1	-2/-1
ENSG00000187097	ENSG00000119723	3.52e-153	235	99.574	234	1	-2	2	-2/2
ENSG00000105750	ENSG00000198521	3.2e-131	68	80.882	55	13	-3	-1	-3/-1
ENSG00000105750	ENSG00000198521	7.77e-126	68	80.882	55	13	-3	-1	-3/-1
ENSG00000117713	ENSG00000049618	0	65	80	52	13	3	1	3/1
ENSG00000183979	ENSG00000185813	2.26e-85	63	100	63	0	3	-1	3/-1
ENSG00000184924	ENSG00000138092	4.63e-41	54	100	54	0	1	-3	1/-3
ENSG00000184924	ENSG00000138092	4.63e-41	54	100	54	0	1	-3	1/-3
ENSG00000241595	ENSG00000187272	1.53e-75	151	83.444	126	25	-2	-1	-2/-1
ENSG00000241595	ENSG00000239886	6.5e-79	151	83.444	126	25	-2	-1	-2/-1
ENSG00000205409	ENSG00000183269	3.17e-176	320	84.375	270	50	-3	-2	-3/-2
ENSG00000099290	ENSG00000172661	0	958	98.225	941	17	1	3	1/3
ENSG00000185262	ENSG00000153443	1.02e-47	103	83.495	86	17	2	1	2/1
ENSG00000188305	ENSG00000110090	5.38e-41	85	83.529	71	14	-2	1	-2/1
ENSG00000188305	ENSG00000170542	4.23e-46	84	90.476	76	8	3	2	3/2
ENSG00000256229	ENSG00000237440	0	162	80.247	130	32	3	2	3/2
ENSG00000229292	ENSG00000223638	0	302	99.007	299	3	3	1	3/1
ENSG00000187068	ENSG00000215193	6.07e-58	96	83.333	80	16	-1	-2	-1/-2
ENSG00000187068	ENSG00000171208	3.36e-60	94	82.979	78	16	-1	-3	-1/-3
ENSG00000127955	ENSG00000065135	0	362	92.541	335	27	2	3	2/3
ENSG00000067048	ENSG00000215301	0	493	95.132	469	24	2	3	2/3
ENSG00000049618	ENSG00000117713	0	110	83.636	92	18	2	1	2/1
ENSG00000185070	ENSG00000175782	7.07e-177	91	80.22	73	18	-1	1	-1/1
ENSG00000213096	ENSG00000167232	6.6e-61	112	85.714	96	16	1	2	1/2
ENSG00000003509	ENSG00000197296	6.14e-43	96	81.25	78	18	-2	3	-2/3
ENSG00000182685	ENSG00000106384	2.48e-35	54	81.481	44	10	-1	-2	-1/-2
ENSG00000181449	ENSG00000182968	4.13e-72	99	90.909	90	9	3	1	3/1
ENSG00000184911	ENSG00000269502	0	340	98.824	336	4	-2	-3	-2/-3
ENSG00000127249	ENSG00000187527	0	108	80.556	87	21	3	2	3/2
ENSG00000140379	ENSG00000180953	3.29e-41	73	82.192	60	13	-1	-3	-1/-3
ENSG00000034677	ENSG00000116514	0	86	82.558	71	15	3	1	3/1
ENSG00000185298	ENSG00000204237	5.16e-21	54	100	54	0	-1	2	-1/2
ENSG00000114331	ENSG00000131584	1.5e-81	122	81.148	99	23	1	3	1/3
ENSG00000169660	ENSG00000181396	1.14e-15	67	100	67	0	-2	2	-2/2
ENSG00000177138	ENSG00000183304	8.4e-123	87	94.253	82	5	-3	-2	-3/-2
ENSG00000204880	ENSG00000212721	4.56e-170	123	88.618	109	14	-2	-3	-2/-3
ENSG00000204880	ENSG00000212722	3.73e-128	110	80	88	22	-2	-1	-2/-1
ENSG00000267368	ENSG00000267645	0	198	100	198	0	1	2	1/2
ENSG00000267368	ENSG00000168255	0	165	99.394	164	1	-3	-1	-3/-1
ENSG00000188672	ENSG00000187010	0	341	92.962	317	24	2	1	2/1
ENSG00000133477	ENSG00000175782	4.22e-100	94	80.851	76	18	1	3	1/3
ENSG00000185475	ENSG00000168569	1.41e-85	145	100	145	0	1	-1	1/-1
ENSG00000169967	ENSG00000198909	0	278	85.612	238	40	2	3	2/3
ENSG00000186354	ENSG00000213694	4.01e-25	50	98	49	1	-2	-3	-2/-3
ENSG00000187569	ENSG00000158427	3.92e-41	95	90.526	86	9	2	-1	2/-1
ENSG00000215252	ENSG00000232653	0	274	85.036	233	41	3	1	3/1
ENSG00000215252	ENSG00000175265	0	258	100	258	0	-1	-3	-1/-3
ENSG00000182255	ENSG00000177272	6.96e-172	133	91.729	122	11	2	3	2/3
ENSG00000182255	ENSG00000177301	1.59e-170	133	90.226	120	13	2	3	2/3
ENSG00000188229	ENSG00000261456	0	296	88.514	262	34	-3	-1	-3/-1
ENSG00000188229	ENSG00000137285	0	274	98.905	271	3	2	1	2/1
ENSG00000132819	ENSG00000112183	2.97e-70	127	85.039	108	19	2	3	2/3
ENSG00000140505	ENSG00000140465	0	127	81.89	104	23	1	2	1/2
ENSG00000140505	ENSG00000140465	0	127	81.89	104	23	1	3	1/3
ENSG00000184697	ENSG00000213937	1.15e-77	86	86.047	74	12	1	2	1/2
ENSG00000109771	ENSG00000100104	2.7e-32	51	80.392	41	10	-3	3	-3/3
ENSG00000038382	ENSG00000160145	0	364	85.165	310	54	1	2	1/2
ENSG00000038382	ENSG00000160145	0	364	85.165	310	54	1	2	1/2
ENSG00000187871	ENSG00000129221	3.3e-41	57	84.211	48	9	-1	1	-1/1
ENSG00000187871	ENSG00000129221	2.23e-34	57	84.211	48	9	3	-1	3/-1
ENSG00000187871	ENSG00000129221	3.3e-41	57	84.211	48	9	-1	3	-1/3
ENSG00000187871	ENSG00000129221	2.23e-34	57	84.211	48	9	3	-3	3/-3
ENSG00000164916	ENSG00000278129	1.19e-51	99	85.859	85	14	3	1	3/1
ENSG00000100077	ENSG00000173020	0	687	83.988	577	110	1	3	1/3
ENSG00000100077	ENSG00000100784	4.57e-53	63	80.952	51	12	-3	-1	-3/-1
ENSG00000123143	ENSG00000065243	0	331	80.363	266	65	2	3	2/3
ENSG00000105875	ENSG00000178202	2.15e-50	82	80.488	66	16	-3	-2	-3/-2
ENSG00000105875	ENSG00000167693	4.11e-46	83	84.337	70	13	-3	1	-3/1
ENSG00000182782	ENSG00000255398	0	379	95.515	362	17	1	3	1/3
ENSG00000169131	ENSG00000178338	0	433	81.062	351	82	2	3	2/3
ENSG00000175745	ENSG00000185551	0	339	96.165	326	13	2	1	2/1
ENSG00000183161	ENSG00000119917	1.06e-37	66	84.848	56	10	3	-2	3/-2
ENSG00000183161	ENSG00000119917	1.06e-37	66	84.848	56	10	3	-2	3/-2
ENSG00000065883	ENSG00000167258	0	364	87.912	320	44	1	3	1/3
ENSG00000184185	ENSG00000260458	0	500	97.2	486	14	-3	-1	-3/-1
ENSG00000176401	ENSG00000188283	1.79e-33	53	84.906	45	8	1	-2	1/-2
ENSG00000183145	ENSG00000197937	6.26e-65	67	80.597	54	13	3	-3	3/-3
ENSG00000171703	ENSG00000187735	1.54e-61	62	83.871	52	10	-3	-2	-3/-2
ENSG00000187082	ENSG00000186579	3.44e-60	100	100	100	0	3	2	3/2
ENSG00000187082	ENSG00000186579	6e-51	100	100	100	0	1	3	1/3
ENSG00000054793	ENSG00000166377	0	570	82.281	469	101	2	3	2/3
ENSG00000187546	ENSG00000171208	3.54e-27	50	80	40	10	3	-2	3/-2
ENSG00000100319	ENSG00000100314	1.42e-83	139	97.122	135	4	1	-1	1/-1
ENSG00000182108	ENSG00000179583	5.02e-143	228	98.684	225	3	-1	3	-1/3
ENSG00000124593	ENSG00000278224	0	279	100	279	0	3	1	3/1
ENSG00000165650	ENSG00000165646	0	718	100	718	0	-2	2	-2/2
ENSG00000165650	ENSG00000108306	3.98e-42	52	84.615	44	8	-3	-1	-3/-1
ENSG00000044574	ENSG00000109971	0	82	85.366	70	12	1	2	1/2
ENSG00000075407	ENSG00000196693	0	77	81.818	63	14	3	2	3/2
ENSG00000124208	ENSG00000244687	0	505	100	505	0	3	2	3/2
ENSG00000124208	ENSG00000244687	0	505	100	505	0	3	2	3/2
ENSG00000124208	ENSG00000244687	0	505	100	505	0	3	2	3/2
ENSG00000214274	ENSG00000258818	6.17e-121	90	98.889	89	1	2	1	2/1
ENSG00000198093	ENSG00000176024	0	68	89.706	61	7	1	2	1/2
ENSG00000121207	ENSG00000166471	3.49e-38	53	81.132	43	10	-1	3	-1/3
ENSG00000186399	ENSG00000206127	0	221	99.095	219	2	2	1	2/1
ENSG00000186399	ENSG00000232653	0	221	98.643	218	3	2	1	2/1
ENSG00000197238	ENSG00000273542	4.47e-44	89	100	89	0	-3	-1	-3/-1
ENSG00000197238	ENSG00000158406	1.38e-50	85	98.824	84	1	3	2	3/2
ENSG00000113296	ENSG00000105664	0	277	87.004	241	36	2	1	2/1
ENSG00000189051	ENSG00000141759	1.67e-46	65	80	52	13	-1	-2	-1/-2
ENSG00000186230	ENSG00000186272	0	118	84.746	100	18	-2	-3	-2/-3
ENSG00000188976	ENSG00000187634	5.4e-72	124	100	124	0	-1	2	-1/2
ENSG00000188542	ENSG00000144504	5.45e-64	117	99.145	116	1	2	-1	2/-1
ENSG00000157837	ENSG00000138600	4.7e-41	94	81.915	77	17	-2	-1	-2/-1
ENSG00000157837	ENSG00000141569	2.4e-33	68	82.353	56	12	3	2	3/2
ENSG00000197021	ENSG00000197620	0	355	97.183	345	10	-1	-2	-1/-2
ENSG00000197021	ENSG00000197620	0	355	97.183	345	10	-2	-3	-2/-3
ENSG00000172236	ENSG00000095917	0	294	85.374	251	43	1	2	1/2
ENSG00000132356	ENSG00000162409	0	243	82.716	201	42	3	1	3/1
ENSG00000186510	ENSG00000184908	0	687	91.266	627	60	2	1	2/1
ENSG00000131652	ENSG00000103145	2.41e-39	81	100	81	0	1	-1	1/-1
ENSG00000213533	ENSG00000248592	0	264	100	264	0	2	1	2/1
ENSG00000186723	ENSG00000172519	0	325	91.077	296	29	-2	-1	-2/-1
ENSG00000183486	ENSG00000157601	2e-41	77	80.519	62	15	-2	-3	-2/-3
ENSG00000153250	ENSG00000144642	1.17e-162	194	87.113	169	25	3	1	3/1
ENSG00000184357	ENSG00000168298	6.8e-29	71	95.775	68	3	1	2	1/2
ENSG00000135226	ENSG00000213759	0	572	93.881	537	35	3	1	3/1
ENSG00000135226	ENSG00000109181	0	545	87.89	479	66	3	1	3/1
ENSG00000119946	ENSG00000148842	0	82	85.366	70	12	2	3	2/3
ENSG00000100023	ENSG00000100027	0	569	100	569	0	2	-2	2/-2
ENSG00000150551	ENSG00000183840	1.96e-113	165	100	165	0	-2	3	-2/3
ENSG00000182393	ENSG00000197110	1.92e-51	85	80	68	17	-2	-3	-2/-3
ENSG00000116721	ENSG00000204481	0	486	96.091	467	19	-3	-1	-3/-1
ENSG00000116721	ENSG00000120952	0	547	94.333	516	31	2	1	2/1
ENSG00000182968	ENSG00000134595	4.7e-59	69	86.957	60	9	1	3	1/3
ENSG00000182968	ENSG00000181449	1e-50	71	91.549	65	6	1	3	1/3
ENSG00000177732	ENSG00000176887	3.6e-56	78	87.179	68	10	1	2	1/2
ENSG00000170482	ENSG00000089057	0	100	81	81	19	3	1	3/1
ENSG00000186562	ENSG00000186599	4.36e-74	110	100	110	0	1	2	1/2
ENSG00000076555	ENSG00000278540	0	266	87.594	233	33	3	1	3/1
ENSG00000183032	ENSG00000198807	2.08e-80	142	100	142	0	-1	2	-1/2
ENSG00000096746	ENSG00000126945	8.56e-99	77	85.714	66	11	2	1	2/1
ENSG00000188629	ENSG00000270011	0	514	100	514	0	-1	-2	-1/-2
ENSG00000116604	ENSG00000068305	5.28e-128	103	91.262	94	9	2	3	2/3
ENSG00000183077	ENSG00000156381	3.07e-48	92	81.522	75	17	2	-1	2/-1
ENSG00000183077	ENSG00000156381	4.05e-35	92	81.522	75	17	-3	3	-3/3
ENSG00000241476	ENSG00000268447	0	357	100	357	0	-3	-2	-3/-2
ENSG00000241476	ENSG00000165584	0	50	96	48	2	3	1	3/1
ENSG00000241476	ENSG00000165584	0	50	96	48	2	-3	-2	-3/-2
ENSG00000241476	ENSG00000165584	0	50	96	48	2	2	3	2/3
ENSG00000131183	ENSG00000157765	3.85e-152	139	80.576	112	27	2	1	2/1
ENSG00000182504	ENSG00000175782	2.79e-86	54	83.333	45	9	-1	3	-1/3
ENSG00000158623	ENSG00000181789	0	585	83.761	490	95	2	3	2/3
ENSG00000186329	ENSG00000162924	0	238	82.773	197	41	3	2	3/2
ENSG00000186329	ENSG00000174749	0	231	80.519	186	45	2	-2	2/-2
ENSG00000138756	ENSG00000163291	0	415	98.795	410	5	3	-1	3/-1
ENSG00000176046	ENSG00000066427	3.89e-171	67	80.597	54	13	2	3	2/3
ENSG00000176046	ENSG00000175782	9.61e-118	70	80	56	14	3	-3	3/-3
ENSG00000146755	ENSG00000178809	0	316	93.354	295	21	1	3	1/3
ENSG00000169953	ENSG00000172468	5.99e-135	205	98.537	202	3	-2	-1	-2/-1
ENSG00000243955	ENSG00000182793	4e-153	250	84	210	40	-3	-2	-3/-2
ENSG00000159899	ENSG00000169418	0	368	80.435	296	72	1	2	1/2
ENSG00000188295	ENSG00000223547	5.52e-133	60	80	48	12	-1	-3	-1/-3
ENSG00000177370	ENSG00000159842	6.25e-28	51	100	51	0	2	-1	2/-1
ENSG00000177370	ENSG00000159842	7.32e-26	51	100	51	0	-2	1	-2/1
ENSG00000177370	ENSG00000159842	2.61e-25	51	100	51	0	3	-2	3/-2
ENSG00000177370	ENSG00000159842	2.61e-25	51	100	51	0	-1	3	-1/3
ENSG00000065029	ENSG00000166478	0	217	82.949	180	37	3	1	3/1
ENSG00000182979	ENSG00000057935	3.19e-135	61	80.328	49	12	-3	-1	-3/-1
ENSG00000198650	ENSG00000076067	6.18e-49	94	80.851	76	18	3	2	3/2
ENSG00000198650	ENSG00000133488	1.08e-47	93	80.645	75	18	3	-1	3/-1
ENSG00000123416	ENSG00000167552	0	447	91.499	409	38	-3	-1	-3/-1
ENSG00000132746	ENSG00000006534	0	327	82.875	271	56	2	1	2/1
ENSG00000186298	ENSG00000172531	0	304	96.382	293	11	2	3	2/3
ENSG00000183864	ENSG00000141232	1.45e-68	121	80.165	97	24	3	1	3/1
ENSG00000186714	ENSG00000149100	1.8e-146	251	98.805	248	3	-2	1	-2/1
ENSG00000099977	ENSG00000099974	1.61e-61	104	96.154	100	4	-2	-3	-2/-3
ENSG00000113456	ENSG00000101966	9.13e-46	54	81.481	44	10	-3	-2	-3/-2
ENSG00000060971	ENSG00000008226	3.34e-88	143	97.902	140	3	1	-1	1/-1
ENSG00000134183	ENSG00000114349	0	344	82.558	284	60	2	1	2/1
ENSG00000187559	ENSG00000273514	0	476	99.16	472	4	3	1	3/1
ENSG00000187559	ENSG00000184492	0	272	95.956	261	11	3	2	3/2
ENSG00000177143	ENSG00000147400	1.09e-38	52	90.385	47	5	-1	-3	-1/-3
ENSG00000180219	ENSG00000162771	1.7e-62	89	82.022	73	16	-2	-1	-2/-1
ENSG00000101782	ENSG00000081320	1.89e-31	51	82.353	42	9	1	-3	1/-3
ENSG00000185100	ENSG00000035687	0	91	85.714	78	13	2	3	2/3
ENSG00000125816	ENSG00000136352	2.5e-77	57	100	57	0	3	1	3/1
ENSG00000125816	ENSG00000136352	1.24e-74	57	100	57	0	3	1	3/1
ENSG00000186889	ENSG00000182318	5.55e-47	56	82.143	46	10	-2	2	-2/2
ENSG00000186889	ENSG00000077157	3.11e-35	52	82.692	43	9	3	2	3/2
ENSG00000102743	ENSG00000120329	0	315	86.667	273	42	3	1	3/1
ENSG00000119720	ENSG00000100764	0	567	99.471	564	3	-3	3	-3/3
ENSG00000187486	ENSG00000121361	2.14e-70	64	81.25	52	12	-3	-2	-3/-2
ENSG00000124486	ENSG00000114374	0	332	89.458	297	35	-1	-3	-1/-3
ENSG00000163798	ENSG00000119760	1.49e-79	123	100	123	0	2	-2	2/-2
ENSG00000163798	ENSG00000119760	6.74e-78	123	100	123	0	-2	2	-2/2
ENSG00000163798	ENSG00000119760	3.86e-75	123	100	123	0	-1	1	-1/1
ENSG00000186579	ENSG00000187082	3.21e-60	100	100	100	0	2	3	2/3
ENSG00000186579	ENSG00000187082	5.6e-51	100	100	100	0	3	1	3/1
ENSG00000184270	ENSG00000233822	2.99e-62	109	94.495	103	6	1	-1	1/-1
ENSG00000197928	ENSG00000197497	0	52	82.692	43	9	3	1	3/1
ENSG00000182334	ENSG00000183303	4.39e-61	65	84.615	55	10	3	1	3/1
ENSG00000223443	ENSG00000226430	0	636	92.296	587	49	3	1	3/1
ENSG00000223443	ENSG00000236125	0	531	96.234	511	20	3	1	3/1
ENSG00000188021	ENSG00000135018	0	153	90.85	139	14	2	3	2/3
ENSG00000188021	ENSG00000135018	0	153	90.85	139	14	2	1	2/1
ENSG00000197172	ENSG00000221867	0	466	96.996	452	14	3	2	3/2
ENSG00000182348	ENSG00000170396	5.6e-32	60	81.667	49	11	-2	-3	-2/-3
ENSG00000197054	ENSG00000171295	0	289	85.467	247	42	-2	-1	-2/-1
ENSG00000197054	ENSG00000196757	0	191	86.387	165	26	-3	-1	-3/-1
ENSG00000197226	ENSG00000109436	0	129	82.946	107	22	3	1	3/1
ENSG00000164749	ENSG00000101076	0	204	81.373	166	38	1	2	1/2
ENSG00000105991	ENSG00000120094	1.33e-44	65	86.154	56	9	3	1	3/1
ENSG00000187257	ENSG00000081019	0	363	82.369	299	64	1	2	1/2
ENSG00000179361	ENSG00000116017	8.92e-97	135	84.444	114	21	1	3	1/3
ENSG00000108175	ENSG00000122515	1.44e-174	156	85.256	133	23	-1	-2	-1/-2
ENSG00000185640	ENSG00000205420	0	75	89.333	67	8	3	1	3/1
ENSG00000185640	ENSG00000170465	0	75	88	66	9	3	1	3/1
ENSG00000188316	ENSG00000187164	0	237	100	237	0	-1	1	-1/1
ENSG00000188316	ENSG00000165868	2.15e-24	58	96.552	56	2	1	-2	1/-2
ENSG00000155506	ENSG00000138709	0	192	82.812	159	33	1	2	1/2
ENSG00000180613	ENSG00000169840	1.01e-45	78	82.051	64	14	3	1	3/1
ENSG00000197454	ENSG00000203663	0	363	85.124	309	54	-2	-1	-2/-1
ENSG00000197454	ENSG00000203663	0	363	85.124	309	54	-2	-1	-2/-1
ENSG00000198754	ENSG00000083720	0	218	81.193	177	41	1	3	1/3
ENSG00000120088	ENSG00000263715	0	582	100	582	0	-3	-2	-3/-2
ENSG00000161542	ENSG00000141127	1.15e-151	96	83.333	80	16	3	2	3/2
ENSG00000183395	ENSG00000185480	2.4e-91	83	98.795	82	1	2	-1	2/-1
ENSG00000267680	ENSG00000256294	9.59e-107	71	83.099	59	12	-2	-1	-2/-1
ENSG00000146587	ENSG00000164631	0	50	84	42	8	1	3	1/3
ENSG00000083312	ENSG00000105576	0	481	90.229	434	47	1	2	1/2
ENSG00000119723	ENSG00000187097	1.22e-153	235	99.574	234	1	2	-2	2/-2
ENSG00000119723	ENSG00000187097	1.13e-144	235	99.574	234	1	-3	1	-3/1
ENSG00000186666	ENSG00000136213	1.41e-57	103	91.262	94	9	1	2	1/2
ENSG00000186666	ENSG00000173559	5.43e-54	100	93	93	7	3	2	3/2
ENSG00000178202	ENSG00000101670	3.98e-35	52	82.692	43	9	2	-2	2/-2
ENSG00000243489	ENSG00000221837	5.76e-140	57	91.228	52	5	-1	-3	-1/-3
ENSG00000243489	ENSG00000215455	1.08e-136	89	82.022	73	16	-3	-2	-3/-2
ENSG00000178177	ENSG00000109805	0	474	100	474	0	1	-2	1/-2
ENSG00000145907	ENSG00000138757	8.66e-144	142	80.986	115	27	3	1	3/1
ENSG00000197275	ENSG00000265817	0	719	100	719	0	3	1	3/1
ENSG00000185650	ENSG00000152518	2.84e-54	82	87.805	72	10	2	1	2/1
ENSG00000171916	ENSG00000168961	0	322	94.72	305	17	1	2	1/2
ENSG00000171916	ENSG00000168961	0	322	94.72	305	17	1	2	1/2
ENSG00000165185	ENSG00000153721	1.7e-95	65	81.538	53	12	-3	-2	-3/-2
ENSG00000188152	ENSG00000130950	0	307	98.371	302	5	2	1	2/1
ENSG00000185926	ENSG00000258817	1.3e-156	262	84.351	221	41	1	3	1/3
ENSG00000178802	ENSG00000178761	0	744	100	744	0	-2	2	-2/2
ENSG00000197136	ENSG00000100731	0	61	86.885	53	8	3	2	3/2
ENSG00000188315	ENSG00000148734	1.06e-34	79	81.013	64	15	1	-1	1/-1
ENSG00000166734	ENSG00000157734	1.66e-46	52	88.462	46	6	-2	-3	-2/-3
ENSG00000187527	ENSG00000127249	0	108	80.556	87	21	2	3	2/3
ENSG00000237247	ENSG00000205718	3.09e-179	257	99.222	255	2	-1	-3	-1/-3
ENSG00000237247	ENSG00000182315	1.92e-177	257	98.444	253	4	-1	-3	-1/-3
ENSG00000237247	ENSG00000182315	1.3e-160	257	98.444	253	4	2	3	2/3
ENSG00000179914	ENSG00000158764	0	283	88.693	251	32	3	2	3/2
ENSG00000145194	ENSG00000163888	3.42e-84	124	100	124	0	-2	1	-2/1
ENSG00000131584	ENSG00000114331	1.81e-67	122	81.148	99	23	3	1	3/1
ENSG00000178809	ENSG00000155428	0	345	99.42	343	2	-2	-3	-2/-3
ENSG00000186599	ENSG00000186562	4.36e-74	110	100	110	0	2	1	2/1
ENSG00000221926	ENSG00000108448	0	447	97.763	437	10	3	2	3/2
ENSG00000188467	ENSG00000104177	0	222	97.297	216	6	-2	1	-2/1
ENSG00000188467	ENSG00000104177	1.61e-130	222	97.297	216	6	-2	2	-2/2
ENSG00000183682	ENSG00000116985	0	325	95.692	311	14	-3	-1	-3/-1
ENSG00000187630	ENSG00000157326	0	235	91.064	214	21	1	3	1/3
ENSG00000122824	ENSG00000196368	8.89e-136	177	96.045	170	7	-3	-2	-3/-2
ENSG00000196961	ENSG00000183020	0	649	88.906	577	72	2	1	2/1
ENSG00000189369	ENSG00000103342	0	439	96.355	423	16	2	1	2/1
ENSG00000189369	ENSG00000103342	0	439	96.355	423	16	2	3	2/3
ENSG00000206073	ENSG00000057149	0	583	91.767	535	48	1	2	1/2
ENSG00000197165	ENSG00000196502	0	279	90.681	253	26	3	2	3/2
ENSG00000010379	ENSG00000132164	0	241	81.328	196	45	3	1	3/1
ENSG00000198648	ENSG00000172939	0	368	83.424	307	61	2	1	2/1
ENSG00000172367	ENSG00000248712	5.45e-119	170	100	170	0	-2	3	-2/3
ENSG00000172367	ENSG00000248712	1.66e-116	170	100	170	0	3	-2	3/-2
ENSG00000140688	ENSG00000140675	2.95e-122	154	99.351	153	1	-1	2	-1/2
ENSG00000154258	ENSG00000141338	0	427	87.354	373	54	3	1	3/1
ENSG00000054690	ENSG00000100564	1.96e-64	100	100	100	0	-3	2	-3/2
ENSG00000054690	ENSG00000100564	7.57e-61	100	100	100	0	-1	3	-1/3
ENSG00000054690	ENSG00000100564	1.04e-60	100	100	100	0	3	-1	3/-1
ENSG00000054690	ENSG00000100564	5.09e-60	100	100	100	0	1	-2	1/-2
ENSG00000054690	ENSG00000100564	1.81e-59	100	100	100	0	-2	1	-2/1
ENSG00000054690	ENSG00000100564	4.7e-55	100	100	100	0	2	-3	2/-3
ENSG00000189152	ENSG00000154016	1.47e-98	154	98.052	151	3	3	2	3/2
ENSG00000186092	ENSG00000176695	0	351	99.145	348	3	1	3	1/3
ENSG00000162896	ENSG00000167112	8.37e-68	50	80	40	10	1	3	1/3
ENSG00000162896	ENSG00000136213	2e-68	101	87.129	88	13	-3	1	-3/1
ENSG00000135702	ENSG00000183196	0	364	86.538	315	49	1	3	1/3
ENSG00000184486	ENSG00000196767	2.28e-71	144	80.556	116	28	-3	-1	-3/-1
ENSG00000086061	ENSG00000140403	8.11e-169	71	80.282	57	14	1	2	1/2
ENSG00000250571	ENSG00000264668	6.36e-134	77	100	77	0	-1	-3	-1/-3
ENSG00000185838	ENSG00000184058	4.78e-51	88	95.455	84	4	-3	1	-3/1
ENSG00000188375	ENSG00000132475	0	129	96.899	125	4	1	2	1/2
ENSG00000188372	ENSG00000146707	2.12e-126	111	98.198	109	2	-3	-1	-3/-1
ENSG00000113460	ENSG00000113456	1.6e-63	104	100	104	0	-2	1	-2/1
ENSG00000170298	ENSG00000168961	0	263	92.776	244	19	2	1	2/1
ENSG00000170298	ENSG00000171916	0	207	98.068	203	4	3	1	3/1
ENSG00000241484	ENSG00000248405	0	269	100	269	0	1	3	1/3
ENSG00000167720	ENSG00000167721	0	243	99.588	242	1	2	-2	2/-2
ENSG00000189190	ENSG00000198482	0	316	87.658	277	39	1	3	1/3
ENSG00000189190	ENSG00000213799	0	152	80.921	123	29	1	3	1/3
ENSG00000214300	ENSG00000136206	0	121	88.43	107	14	3	1	3/1
ENSG00000214300	ENSG00000170092	1.99e-173	163	86.503	141	22	-1	-2	-1/-2
ENSG00000242515	ENSG00000242366	0	447	93.512	418	29	-1	-3	-1/-3
ENSG00000204481	ENSG00000116721	0	486	96.091	467	19	-1	-3	-1/-3
ENSG00000204481	ENSG00000120952	0	547	92.505	506	41	2	1	2/1
ENSG00000184302	ENSG00000138083	1.39e-127	209	86.603	181	28	2	1	2/1
ENSG00000184083	ENSG00000048828	0	130	80.769	105	25	1	3	1/3
ENSG00000076685	ENSG00000148842	0	528	100	528	0	-1	1	-1/1
ENSG00000184992	ENSG00000138592	1.08e-95	70	91.429	64	6	3	-1	3/-1
ENSG00000105991	ENSG00000120094	5.29e-45	65	86.154	56	9	2	1	2/1
ENSG00000070476	ENSG00000198455	0	311	85.209	265	46	1	2	1/2
ENSG00000171405	ENSG00000171402	5.55e-50	95	82.105	78	17	-2	-1	-2/-1
ENSG00000187766	ENSG00000189169	1.17e-100	84	82.143	69	15	-1	-2	-1/-2
ENSG00000168930	ENSG00000182053	0	582	95.533	556	26	-1	-3	-1/-3
ENSG00000196565	ENSG00000213934	1.3e-124	195	97.949	191	4	1	3	1/3
ENSG00000186432	ENSG00000102753	0	523	85.851	449	74	1	2	1/2
ENSG00000188368	ENSG00000079462	3.07e-57	91	100	91	0	3	-2	3/-2
ENSG00000188368	ENSG00000079462	1.28e-46	91	100	91	0	2	-1	2/-1
ENSG00000186364	ENSG00000131788	9.67e-100	143	100	143	0	-2	2	-2/2
ENSG00000186364	ENSG00000131788	6.01e-94	143	100	143	0	2	-2	2/-2
ENSG00000186364	ENSG00000131788	9.68e-92	143	100	143	0	3	-3	3/-3
ENSG00000186364	ENSG00000131788	8.26e-90	143	100	143	0	-3	3	-3/3
ENSG00000182053	ENSG00000204449	0	511	95.108	486	25	1	3	1/3
ENSG00000139131	ENSG00000139719	5.13e-43	86	82.558	71	15	-1	3	-1/3
ENSG00000147649	ENSG00000198393	1.05e-46	62	83.871	52	10	-2	3	-2/3
ENSG00000184898	ENSG00000138600	4.76e-72	60	80	48	12	-2	2	-2/2
ENSG00000184898	ENSG00000063245	3.27e-26	56	80.357	45	11	3	1	3/1
ENSG00000183318	ENSG00000214300	1.48e-72	71	83.099	59	12	-2	-1	-2/-1
ENSG00000187325	ENSG00000273841	1.16e-117	137	90.511	124	13	3	1	3/1
ENSG00000157823	ENSG00000250021	0	584	98.801	577	7	-3	-2	-3/-2
ENSG00000157823	ENSG00000177879	3.28e-108	192	84.375	162	30	1	3	1/3
ENSG00000166192	ENSG00000144401	4.63e-33	51	82.353	42	9	3	2	3/2
ENSG00000058404	ENSG00000070808	0	476	85.714	408	68	2	1	2/1
ENSG00000129993	ENSG00000079102	0	211	86.73	183	28	2	1	2/1
ENSG00000125482	ENSG00000173889	4.69e-37	76	85.526	65	11	1	2	1/2
ENSG00000161671	ENSG00000198393	2.46e-169	51	82.353	42	9	-2	-3	-2/-3
ENSG00000161671	ENSG00000198393	3.82e-132	51	82.353	42	9	-2	-3	-2/-3
ENSG00000215695	ENSG00000197312	0	441	100	441	0	-2	-1	-2/-1
ENSG00000185236	ENSG00000103769	1.16e-103	155	95.484	148	7	3	1	3/1
ENSG00000065923	ENSG00000198689	0	204	82.843	169	35	3	1	3/1
ENSG00000180638	ENSG00000142494	3.04e-142	87	81.609	71	16	1	3	1/3
ENSG00000156049	ENSG00000088256	0	352	82.386	290	62	2	3	2/3
ENSG00000125498	ENSG00000167633	0	230	83.043	191	39	2	1	2/1
ENSG00000182791	ENSG00000173992	3.51e-54	87	100	87	0	3	-3	3/-3
ENSG00000196735	ENSG00000237541	0	323	85.449	276	47	-2	-1	-2/-1
ENSG00000008256	ENSG00000108669	0	363	87.328	317	46	3	2	3/2
ENSG00000204510	ENSG00000182330	0	383	99.739	382	1	-3	-2	-3/-2
ENSG00000244734	ENSG00000223609	1.73e-87	161	85.093	137	24	-3	-1	-3/-1
ENSG00000124635	ENSG00000180596	2.66e-44	74	91.892	68	6	-2	-1	-2/-1
ENSG00000177688	ENSG00000188612	2.9e-167	137	86.131	118	19	2	1	2/1
ENSG00000177688	ENSG00000188612	1.14e-161	137	86.131	118	19	-2	-3	-2/-3
ENSG00000182534	ENSG00000138442	1.62e-105	76	80.263	61	15	1	-2	1/-2
ENSG00000182534	ENSG00000175782	1.01e-87	67	80.597	54	13	-1	1	-1/1
ENSG00000160868	ENSG00000160870	0	505	88.515	447	58	2	1	2/1
ENSG00000160868	ENSG00000282301	0	499	88.377	441	58	2	1	2/1
ENSG00000102053	ENSG00000149289	0	258	83.333	215	43	2	1	2/1
ENSG00000160200	ENSG00000274276	0	749	100	749	0	2	1	2/1
ENSG00000182580	ENSG00000133216	0	401	83.541	335	66	3	2	3/2
ENSG00000182580	ENSG00000133216	0	401	83.541	335	66	3	1	3/1
ENSG00000277858	ENSG00000274183	1.46e-61	62	100	62	0	-3	-2	-3/-2
ENSG00000186393	ENSG00000171446	1.49e-174	322	80.745	260	62	2	3	2/3
ENSG00000167850	ENSG00000167851	7.28e-72	138	80.435	111	27	2	3	2/3
ENSG00000167850	ENSG00000167851	7.28e-72	138	80.435	111	27	2	1	2/1
ENSG00000188153	ENSG00000187498	0	230	83.478	192	38	2	3	2/3
ENSG00000180425	ENSG00000076053	2.71e-88	129	100	129	0	-2	2	-2/2
ENSG00000180425	ENSG00000076053	2.31e-86	129	100	129	0	2	-2	2/-2
ENSG00000180425	ENSG00000076053	1.33e-75	129	100	129	0	1	-1	1/-1
ENSG00000197658	ENSG00000149742	1.29e-63	60	80	48	12	3	2	3/2
ENSG00000183706	ENSG00000176294	6.07e-150	309	85.761	265	44	2	1	2/1
ENSG00000205927	ENSG00000177468	8.87e-60	93	84.946	79	14	2	3	2/3
ENSG00000198466	ENSG00000173480	0	745	91.812	684	61	1	2	1/2
ENSG00000128951	ENSG00000198633	2.29e-53	64	84.375	54	10	-2	-1	-2/-1
ENSG00000177300	ENSG00000151718	0	635	100	635	0	-1	3	-1/3
ENSG00000177300	ENSG00000185758	1.63e-134	203	90.148	183	20	3	2	3/2
ENSG00000198624	ENSG00000100784	4.55e-52	95	82.105	78	17	-1	-3	-1/-3
ENSG00000198624	ENSG00000166448	1.38e-48	90	86.667	78	12	-1	-3	-1/-3
ENSG00000183054	ENSG00000015568	0	946	100	946	0	-2	-3	-2/-3
ENSG00000183054	ENSG00000169629	0	802	99.751	800	2	3	1	3/1
ENSG00000153234	ENSG00000123358	8.3e-162	87	93.103	81	6	1	2	1/2
ENSG00000180423	ENSG00000269404	1.45e-43	51	82.353	42	9	2	1	2/1
ENSG00000179750	ENSG00000128383	8.35e-173	229	93.886	215	14	1	3	1/3
ENSG00000099783	ENSG00000104177	8.2e-139	91	80.22	73	18	2	3	2/3
ENSG00000258588	ENSG00000258659	0	550	100	550	0	3	2	3/2
ENSG00000160870	ENSG00000160868	0	506	88.538	448	58	2	3	2/3
ENSG00000131653	ENSG00000167971	4.74e-161	262	100	262	0	2	-3	2/-3
ENSG00000197479	ENSG00000120328	0	672	89.583	602	70	2	1	2/1
ENSG00000162194	ENSG00000278615	3.03e-127	189	100	189	0	1	3	1/3
ENSG00000135480	ENSG00000186081	1.04e-149	68	83.824	57	11	1	2	1/2
ENSG00000135480	ENSG00000170454	7.9e-147	70	81.429	57	13	1	3	1/3
ENSG00000179083	ENSG00000234545	4.69e-61	61	90.164	55	6	2	1	2/1
ENSG00000183785	ENSG00000198033	0	437	91.533	400	37	2	1	2/1
ENSG00000119711	ENSG00000119636	6.16e-45	65	93.846	61	4	-2	2	-2/2
ENSG00000134086	ENSG00000148483	3.97e-49	54	85.185	46	8	3	2	3/2
ENSG00000185332	ENSG00000130368	8.16e-29	71	80.282	57	14	-2	1	-2/1
ENSG00000276368	ENSG00000196747	1.96e-57	126	96.032	121	5	2	1	2/1
ENSG00000198429	ENSG00000171295	0	307	86.319	265	42	-1	-3	-1/-3
ENSG00000198429	ENSG00000197054	1.54e-82	132	84.091	111	21	2	1	2/1
ENSG00000037897	ENSG00000123427	3.93e-40	64	100	64	0	1	-3	1/-3
ENSG00000037897	ENSG00000123427	5.4e-40	64	100	64	0	3	-2	3/-2
ENSG00000186919	ENSG00000182473	1e-132	69	100	69	0	-1	1	-1/1
ENSG00000186919	ENSG00000182473	1.14e-132	69	100	69	0	-1	1	-1/1
ENSG00000198390	ENSG00000182816	5.6e-115	174	91.379	159	15	2	3	2/3
ENSG00000198390	ENSG00000240432	9.61e-26	58	84.483	49	9	-2	-1	-2/-1
ENSG00000182783	ENSG00000203661	0	336	99.405	334	2	-2	-3	-2/-3
ENSG00000249471	ENSG00000083812	0	333	93.093	310	23	3	2	3/2
ENSG00000177693	ENSG00000176695	0	351	99.145	348	3	1	3	1/3
ENSG00000188505	ENSG00000134042	4.31e-31	51	80.392	41	10	2	3	2/3
ENSG00000188505	ENSG00000134042	4.31e-31	51	80.392	41	10	2	1	2/1
ENSG00000169594	ENSG00000173068	0	80	87.5	70	10	3	2	3/2
ENSG00000112144	ENSG00000111837	0	305	83.934	256	49	3	1	3/1
ENSG00000205212	ENSG00000170160	4.27e-97	163	95.706	156	7	1	2	1/2
ENSG00000184787	ENSG00000167703	1.92e-51	69	84.058	58	11	2	1	2/1
ENSG00000206181	ENSG00000183791	0	269	82.156	221	48	-2	-3	-2/-3
ENSG00000206181	ENSG00000274744	0	269	82.156	221	48	-2	-3	-2/-3
ENSG00000142453	ENSG00000130733	4.97e-138	245	100	245	0	-1	2	-1/2
ENSG00000167460	ENSG00000198467	2.5e-94	80	91.25	73	7	2	1	2/1
ENSG00000184611	ENSG00000173826	0	325	86.769	282	43	2	3	2/3
ENSG00000187243	ENSG00000154545	0	612	100	612	0	1	2	1/2
ENSG00000261509	ENSG00000275034	0	491	100	491	0	-3	-1	-3/-1
ENSG00000261509	ENSG00000205457	0	491	100	491	0	-3	-1	-3/-1
ENSG00000168903	ENSG00000113303	0	182	82.967	151	31	2	3	2/3
ENSG00000111011	ENSG00000076067	7.07e-40	50	82	41	9	-2	-1	-2/-1
ENSG00000185829	ENSG00000228696	4.42e-161	245	100	245	0	-1	-2	-1/-2
ENSG00000183303	ENSG00000182334	2.81e-118	113	83.186	94	19	1	2	1/2
ENSG00000183303	ENSG00000182334	2.82e-118	113	83.186	94	19	1	3	1/3
ENSG00000119231	ENSG00000163904	2.72e-57	85	80	68	17	-3	-2	-3/-2
ENSG00000164066	ENSG00000112096	0	188	80.851	152	36	-2	-1	-2/-1
ENSG00000164066	ENSG00000151131	0	126	80.159	101	25	-3	-2	-3/-2
ENSG00000186204	ENSG00000171903	0	55	80	44	11	-2	-3	-2/-3
ENSG00000185361	ENSG00000143252	2.58e-115	75	80	60	15	-3	-1	-3/-1
ENSG00000104938	ENSG00000090659	5.27e-174	348	81.609	284	64	-1	-2	-1/-2
ENSG00000090054	ENSG00000074356	1.2e-48	95	80	76	19	2	1	2/1
ENSG00000176490	ENSG00000165023	2.83e-101	126	86.508	109	17	2	1	2/1
ENSG00000181638	ENSG00000264668	0	471	100	471	0	2	1	2/1
ENSG00000157349	ENSG00000168872	0	475	96.842	460	15	3	1	3/1
ENSG00000162971	ENSG00000162972	2.21e-47	83	97.59	81	2	1	-3	1/-3
ENSG00000136197	ENSG00000256646	0	549	100	549	0	1	2	1/2
ENSG00000196620	ENSG00000171234	0	295	82.712	244	51	-2	-1	-2/-1
ENSG00000185561	ENSG00000119820	0	62	82.258	51	11	-2	-1	-2/-1
ENSG00000185561	ENSG00000063245	2.41e-55	58	81.034	47	11	1	2	1/2
ENSG00000104369	ENSG00000149596	1.23e-167	162	80.864	131	31	3	1	3/1
ENSG00000221826	ENSG00000243137	0	476	89.706	427	49	-2	-3	-2/-3
ENSG00000065183	ENSG00000215193	7.85e-72	53	84.906	45	8	-2	2	-2/2
ENSG00000065183	ENSG00000121964	4.89e-60	93	80.645	75	18	-2	-1	-2/-1
ENSG00000184922	ENSG00000161791	6.33e-143	83	86.747	72	11	-2	-3	-2/-3
ENSG00000141404	ENSG00000154889	0	634	100	634	0	-2	1	-2/1
ENSG00000136487	ENSG00000213218	1.88e-179	206	81.068	167	39	-1	-3	-1/-3
ENSG00000197557	ENSG00000196659	0	673	95.097	640	33	2	3	2/3
ENSG00000186564	ENSG00000251493	3.23e-68	105	98.095	103	2	2	1	2/1
ENSG00000186564	ENSG00000187140	1.61e-62	104	91.346	95	9	2	1	2/1
ENSG00000240403	ENSG00000167633	0	56	80.357	45	11	1	2	1/2
ENSG00000197838	ENSG00000255974	0	307	91.205	280	27	-1	-2	-1/-2
ENSG00000197838	ENSG00000198077	0	489	91.207	446	43	1	3	1/3
ENSG00000170917	ENSG00000138685	6.75e-139	196	98.98	194	2	-2	2	-2/2
ENSG00000101558	ENSG00000140526	1.16e-149	106	95.283	101	5	-2	1	-2/1
ENSG00000151364	ENSG00000259112	2.13e-43	78	97.436	76	2	-1	-2	-1/-2
ENSG00000196387	ENSG00000214029	1.53e-165	242	100	242	0	-2	2	-2/2
ENSG00000196387	ENSG00000214029	5.45e-165	242	100	242	0	-1	1	-1/1
ENSG00000196387	ENSG00000214029	5.46e-165	242	100	242	0	1	-2	1/-2
ENSG00000196387	ENSG00000214029	1.53e-161	242	100	242	0	2	-3	2/-3
ENSG00000196387	ENSG00000214029	1.31e-155	242	100	242	0	3	-1	3/-1
ENSG00000186480	ENSG00000125629	1.29e-89	185	84.324	156	29	2	3	2/3
ENSG00000184160	ENSG00000274286	8.02e-113	69	84.058	58	11	3	1	3/1
ENSG00000184160	ENSG00000150594	1.88e-99	119	81.513	97	22	3	1	3/1
ENSG00000143032	ENSG00000125492	5.55e-43	73	82.192	60	13	-1	-2	-1/-2
ENSG00000184678	ENSG00000180596	3.12e-55	92	98.913	91	1	1	2	1/2
ENSG00000158769	ENSG00000117620	5.25e-56	84	80.952	68	16	2	-3	2/-3
ENSG00000158769	ENSG00000117620	1.04e-44	84	80.952	68	16	-3	2	-3/2
ENSG00000196792	ENSG00000115808	0	99	83.838	83	16	3	1	3/1
ENSG00000244509	ENSG00000243811	9.26e-162	125	82.4	103	22	1	2	1/2
ENSG00000244509	ENSG00000128394	0	159	81.761	130	29	1	3	1/3
ENSG00000074047	ENSG00000106571	0	201	82.587	166	35	1	2	1/2
ENSG00000197584	ENSG00000275163	0	365	100	365	0	3	2	3/2
ENSG00000162704	ENSG00000185219	2.28e-130	59	81.356	48	11	3	1	3/1
ENSG00000198807	ENSG00000125813	3.56e-82	146	80.822	118	28	-1	-2	-1/-2
ENSG00000183793	ENSG00000214940	0	319	98.433	314	5	-3	-1	-3/-1
ENSG00000155111	ENSG00000132964	0	371	91.914	341	30	1	3	1/3
ENSG00000107937	ENSG00000148377	0	311	100	311	0	3	-2	3/-2
ENSG00000107937	ENSG00000138600	3.89e-42	60	80	48	12	-2	-3	-2/-3
ENSG00000075391	ENSG00000136848	0	117	84.615	99	18	2	1	2/1
ENSG00000055211	ENSG00000168234	7.68e-19	68	80.882	55	13	-1	2	-1/2
ENSG00000055211	ENSG00000131437	4.26e-43	59	88.136	52	7	-2	2	-2/2
ENSG00000185963	ENSG00000151746	0	185	89.189	165	20	3	2	3/2
ENSG00000197769	ENSG00000167693	9.62e-39	96	81.25	78	18	3	1	3/1
ENSG00000196376	ENSG00000156968	9.63e-40	94	81.915	77	17	-2	3	-2/3
ENSG00000196329	ENSG00000281887	0	355	100	355	0	2	3	2/3
ENSG00000111961	ENSG00000138035	2.92e-38	75	82.667	62	13	-3	1	-3/1
ENSG00000198920	ENSG00000129235	4.03e-33	56	100	56	0	2	-2	2/-2
ENSG00000198920	ENSG00000129235	8.92e-31	56	100	56	0	-3	3	-3/3
ENSG00000198920	ENSG00000129235	4.03e-29	56	100	56	0	1	-1	1/-1
ENSG00000198920	ENSG00000129235	1.44e-28	56	100	56	0	-1	1	-1/1
ENSG00000198920	ENSG00000129235	1.97e-20	56	100	56	0	-2	2	-2/2
ENSG00000196126	ENSG00000198502	0	332	87.952	292	40	-2	-1	-2/-1
ENSG00000065135	ENSG00000127955	0	319	91.85	293	26	3	2	3/2
ENSG00000127124	ENSG00000010818	0	89	89.888	80	9	2	1	2/1
ENSG00000148704	ENSG00000116035	2.62e-55	105	85.714	90	15	1	3	1/3
ENSG00000167112	ENSG00000175782	1.46e-123	86	80.233	69	17	-3	3	-3/3
ENSG00000167112	ENSG00000138592	7.82e-165	52	82.692	43	9	1	-2	1/-2
ENSG00000102290	ENSG00000099715	0	910	98.242	894	16	3	2	3/2
ENSG00000108001	ENSG00000164330	0	267	93.633	250	17	2	3	2/3
ENSG00000019995	ENSG00000175029	0	622	100	622	0	-2	2	-2/2
ENSG00000019995	ENSG00000175029	0	622	100	622	0	1	-3	1/-3
ENSG00000019995	ENSG00000175029	0	622	100	622	0	-1	1	-1/1
ENSG00000122224	ENSG00000169710	7.45e-73	78	80.769	63	15	1	3	1/3
ENSG00000104827	ENSG00000213030	1.49e-172	216	98.611	213	3	3	2	3/2
ENSG00000183520	ENSG00000169213	3.87e-77	64	95.312	61	3	3	-2	3/-2
ENSG00000183520	ENSG00000163428	5.71e-57	50	86	43	7	2	-2	2/-2
ENSG00000132681	ENSG00000163399	0	460	83.043	382	78	1	2	1/2
ENSG00000160401	ENSG00000187024	9.05e-41	72	93.056	67	5	3	-2	3/-2
ENSG00000067533	ENSG00000167703	6.67e-78	99	81.818	81	18	1	-2	1/-2
ENSG00000067533	ENSG00000171208	2.37e-71	53	81.132	43	10	1	2	1/2
ENSG00000170160	ENSG00000107890	0	51	82.353	42	9	2	3	2/3
ENSG00000124120	ENSG00000105519	1.54e-107	94	85.106	80	14	-2	2	-2/2
ENSG00000196584	ENSG00000003402	3.9e-54	51	84.314	43	8	2	3	2/3
ENSG00000196584	ENSG00000112096	1.81e-21	51	80.392	41	10	2	1	2/1
ENSG00000198042	ENSG00000129696	0	257	100	257	0	1	-1	1/-1
ENSG00000198042	ENSG00000129696	0	257	100	257	0	-2	3	-2/3
ENSG00000196550	ENSG00000188610	9.32e-95	155	97.419	151	4	3	1	3/1
ENSG00000171703	ENSG00000187735	2.02e-59	62	83.871	52	10	-3	-2	-3/-2
ENSG00000185013	ENSG00000250741	0	406	100	406	0	1	2	1/2
ENSG00000196678	ENSG00000005187	1.46e-153	234	99.145	232	2	-3	2	-3/2
ENSG00000112305	ENSG00000112309	0	519	100	519	0	-2	3	-2/3
ENSG00000196805	ENSG00000241794	5.03e-115	150	90	135	15	1	2	1/2
ENSG00000196805	ENSG00000203785	4.25e-88	148	88.514	131	17	3	2	3/2
ENSG00000165125	ENSG00000127412	0	523	81.262	425	98	1	2	1/2
ENSG00000100146	ENSG00000125398	1.02e-127	128	89.062	114	14	2	1	2/1
ENSG00000198189	ENSG00000170509	3.7e-104	52	82.692	43	9	2	1	2/1
ENSG00000142615	ENSG00000215704	1.05e-164	258	90.31	233	25	-2	-3	-2/-3
ENSG00000126070	ENSG00000092847	0	708	88.842	629	79	2	3	2/3
ENSG00000069275	ENSG00000215193	6.18e-61	74	86.486	64	10	2	-3	2/-3
ENSG00000125551	ENSG00000183281	0	388	99.742	387	1	2	1	2/1
ENSG00000125551	ENSG00000122194	0	179	89.385	160	19	-3	-2	-3/-2
ENSG00000143515	ENSG00000104043	0	110	88.182	97	13	1	2	1/2
ENSG00000143515	ENSG00000104043	0	110	88.182	97	13	1	2	1/2
ENSG00000164651	ENSG00000217236	1.22e-103	123	96.748	119	4	2	1	2/1
ENSG00000186803	ENSG00000234829	0	274	94.161	258	16	-3	-2	-3/-2
ENSG00000186803	ENSG00000236637	1.54e-179	282	93.262	263	19	1	2	1/2
ENSG00000159455	ENSG00000187180	2.31e-72	66	84.848	56	10	-3	-1	-3/-1
ENSG00000159455	ENSG00000187223	2.13e-70	66	83.333	55	11	-3	-2	-3/-2
ENSG00000159455	ENSG00000187223	2.13e-70	66	83.333	55	11	-2	-1	-2/-1
ENSG00000122435	ENSG00000122477	1.06e-94	174	92.529	161	13	2	-2	2/-2
ENSG00000085265	ENSG00000160339	2.43e-169	234	80.769	189	45	3	2	3/2
ENSG00000143185	ENSG00000143184	2.08e-119	188	95.745	180	8	-2	-3	-2/-3
ENSG00000173535	ENSG00000173530	1.71e-76	111	80.18	89	22	3	1	3/1
ENSG00000011478	ENSG00000138600	9.31e-84	106	81.132	86	20	1	3	1/3
ENSG00000203785	ENSG00000241794	1.35e-124	166	90.964	151	15	1	2	1/2
ENSG00000188603	ENSG00000261832	0	292	100	292	0	-3	-2	-3/-2
ENSG00000198846	ENSG00000124191	1.92e-57	83	81.928	68	15	3	2	3/2
ENSG00000172426	ENSG00000096080	1.29e-151	215	95.349	205	10	-2	1	-2/1
ENSG00000196912	ENSG00000135976	0	762	98.95	754	8	1	2	1/2
ENSG00000221995	ENSG00000196535	0	465	100	465	0	3	2	3/2
ENSG00000221995	ENSG00000196535	0	465	100	465	0	3	2	3/2
ENSG00000117505	ENSG00000100784	2.16e-98	55	81.818	45	10	2	-3	2/-3
ENSG00000117505	ENSG00000100784	3.74e-94	55	81.818	45	10	-2	1	-2/1
ENSG00000165669	ENSG00000126070	4.18e-47	88	81.818	72	16	-2	-3	-2/-3
ENSG00000168116	ENSG00000112200	3.06e-24	74	89.189	66	8	3	1	3/1
ENSG00000122194	ENSG00000125551	0	179	89.385	160	19	-2	-3	-2/-3
ENSG00000122194	ENSG00000183281	0	179	88.827	159	20	-2	-3	-2/-3
ENSG00000162520	ENSG00000162521	1.87e-105	125	99.2	124	1	1	-3	1/-3
ENSG00000203859	ENSG00000203857	0	440	84.773	373	67	-1	-2	-1/-2
ENSG00000198835	ENSG00000182963	3.77e-103	106	81.132	86	20	2	3	2/3
ENSG00000106689	ENSG00000143355	4.66e-137	142	85.915	122	20	2	3	2/3
ENSG00000106689	ENSG00000143355	4.66e-137	142	85.915	122	20	2	1	2/1
ENSG00000162623	ENSG00000116791	1.17e-54	84	100	84	0	2	-1	2/-1
ENSG00000162623	ENSG00000116791	2.04e-53	84	100	84	0	-2	2	-2/2
ENSG00000162623	ENSG00000116791	4.89e-44	84	100	84	0	-1	1	-1/1
ENSG00000160803	ENSG00000135018	5.83e-161	130	86.154	112	18	1	3	1/3
ENSG00000160803	ENSG00000188021	1.25e-154	130	81.538	106	24	1	2	1/2
ENSG00000221864	ENSG00000187175	1.04e-85	52	84.615	44	8	1	2	1/2
ENSG00000167157	ENSG00000116132	9.67e-54	71	92.958	66	5	3	2	3/2
ENSG00000181218	ENSG00000277075	3.67e-64	103	100	103	0	3	1	3/1
ENSG00000181218	ENSG00000272196	1.39e-33	74	87.838	65	9	-1	-3	-1/-3
ENSG00000196406	ENSG00000198021	3.08e-97	214	83.645	179	35	-1	-2	-1/-2
ENSG00000196406	ENSG00000203926	3.08e-97	214	83.645	179	35	-1	-2	-1/-2
ENSG00000188620	ENSG00000215612	1.19e-30	58	91.379	53	5	-3	-2	-3/-2
ENSG00000188620	ENSG00000188816	3.14e-25	57	85.965	49	8	-3	-2	-3/-2
ENSG00000203926	ENSG00000196406	3.13e-109	214	83.645	179	35	-2	-1	-2/-1
ENSG00000143630	ENSG00000138622	0	390	83.333	325	65	3	2	3/2
ENSG00000143630	ENSG00000164588	0	371	83.019	308	63	3	2	3/2
ENSG00000182712	ENSG00000214827	2.31e-90	152	99.342	151	1	-3	-1	-3/-1
ENSG00000188603	ENSG00000261832	0	292	100	292	0	-3	-2	-3/-2
ENSG00000163565	ENSG00000163564	4.57e-178	122	80.328	98	24	2	3	2/3
ENSG00000101182	ENSG00000154611	3.85e-126	219	86.758	190	29	2	1	2/1
ENSG00000131264	ENSG00000113722	5.57e-44	72	84.722	61	11	1	2	1/2
ENSG00000159596	ENSG00000104341	3e-47	66	87.879	58	8	1	-1	1/-1
ENSG00000177272	ENSG00000111262	0	174	82.184	143	31	3	1	3/1
ENSG00000177272	ENSG00000182255	5.56e-173	147	89.796	132	15	3	2	3/2
ENSG00000188394	ENSG00000011454	0	371	100	371	0	-3	-2	-3/-2
ENSG00000188394	ENSG00000011454	0	371	100	371	0	-1	-3	-1/-3
ENSG00000197372	ENSG00000105750	0	92	81.522	75	17	1	2	1/2
ENSG00000143801	ENSG00000080815	1.84e-146	237	81.435	193	44	2	3	2/3
ENSG00000137992	ENSG00000175782	5.82e-153	50	82	41	9	-2	-3	-2/-3
ENSG00000143184	ENSG00000143185	5.97e-119	188	95.745	180	8	-3	-2	-3/-2
ENSG00000203857	ENSG00000203859	0	439	83.827	368	71	1	3	1/3
ENSG00000087502	ENSG00000271601	1.22e-61	91	81.319	74	17	-1	-3	-1/-3
ENSG00000081248	ENSG00000157388	0	318	88.679	282	36	3	1	3/1
ENSG00000081248	ENSG00000157388	0	318	88.679	282	36	3	2	3/2
ENSG00000092847	ENSG00000123908	0	856	82.477	706	150	1	3	1/3
ENSG00000107147	ENSG00000162687	0	480	82.292	395	85	2	1	2/1
ENSG00000171169	ENSG00000164902	3.26e-47	94	87.234	82	12	1	2	1/2
ENSG00000171169	ENSG00000177427	2.37e-47	99	81.818	81	18	-2	-1	-2/-1
ENSG00000116497	ENSG00000180488	1.99e-46	76	82.895	63	13	2	-1	2/-1
ENSG00000203880	ENSG00000168300	7.01e-123	194	83.505	162	32	2	3	2/3
ENSG00000117226	ENSG00000162645	0	75	89.333	67	8	-1	-3	-1/-3
ENSG00000107187	ENSG00000121454	9.39e-141	126	80.952	102	24	3	2	3/2
ENSG00000196227	ENSG00000087470	1.63e-46	70	85.714	60	10	2	1	2/1
ENSG00000132704	ENSG00000160856	8.01e-38	82	85.366	70	12	-3	-2	-3/-2
ENSG00000203950	ENSG00000134590	1.1e-139	186	93.548	174	12	-3	-1	-3/-1
ENSG00000203950	ENSG00000212747	1.68e-137	201	91.045	183	18	-3	-2	-3/-2
ENSG00000072422	ENSG00000008853	0	142	92.254	131	11	1	2	1/2
ENSG00000156398	ENSG00000164466	1.43e-33	56	82.143	46	10	-2	-1	-2/-1
ENSG00000000460	ENSG00000000457	0	314	98.726	310	4	-3	3	-3/3
ENSG00000196663	ENSG00000156381	2.58e-152	240	100	240	0	-2	1	-2/1
ENSG00000196663	ENSG00000156381	7.85e-142	240	100	240	0	3	-1	3/-1
ENSG00000196663	ENSG00000156381	1.37e-124	240	100	240	0	1	-2	1/-2
ENSG00000116985	ENSG00000183682	0	331	95.77	317	14	-1	-3	-1/-3
ENSG00000244474	ENSG00000240224	0	781	95.519	746	35	2	1	2/1
ENSG00000203618	ENSG00000184702	1.79e-86	125	100	125	0	-3	-1	-3/-1
ENSG00000203618	ENSG00000184702	1.79e-86	125	100	125	0	-3	-1	-3/-1
ENSG00000198961	ENSG00000181191	6.04e-114	129	89.922	116	13	1	2	1/2
ENSG00000124233	ENSG00000124157	0	409	80.44	329	80	-3	-2	-3/-2
ENSG00000213190	ENSG00000197622	1.13e-81	99	100	99	0	3	-3	3/-3
ENSG00000198173	ENSG00000189132	0	175	81.143	142	33	1	2	1/2
ENSG00000198173	ENSG00000185448	0	174	84.483	147	27	-2	-1	-2/-1
ENSG00000035403	ENSG00000185009	0	369	100	369	0	-1	2	-1/2
ENSG00000236446	ENSG00000228517	5.4e-158	93	100	93	0	3	2	3/2
ENSG00000184905	ENSG00000133142	5.37e-106	145	80	116	29	3	2	3/2
ENSG00000143556	ENSG00000184330	8.59e-81	145	88.276	128	17	2	1	2/1
ENSG00000180777	ENSG00000148513	0	286	85.664	245	41	-2	-3	-2/-3
ENSG00000133169	ENSG00000133134	1.58e-79	105	95.238	100	5	1	2	1/2
ENSG00000133169	ENSG00000133134	1.57e-79	105	95.238	100	5	1	2	1/2
ENSG00000143632	ENSG00000159251	0	378	98.942	374	4	2	3	2/3
ENSG00000143632	ENSG00000107796	0	378	97.884	370	8	2	1	2/1
ENSG00000134595	ENSG00000182968	2.24e-40	68	88.235	60	8	3	1	3/1
ENSG00000158445	ENSG00000182674	0	481	90.644	436	45	2	1	2/1
ENSG00000172014	ENSG00000260691	0	433	99.538	431	2	1	3	1/3
ENSG00000172014	ENSG00000276203	0	433	99.076	429	4	1	3	1/3
ENSG00000188219	ENSG00000196834	0	1326	96.983	1286	40	1	3	1/3
ENSG00000188219	ENSG00000196604	0	1178	98.642	1162	16	1	2	1/2
ENSG00000136931	ENSG00000116833	3.77e-155	121	89.256	108	13	3	1	3/1
ENSG00000080910	ENSG00000244414	0	172	98.256	169	3	-1	-3	-1/-3
ENSG00000080910	ENSG00000134389	3.31e-132	177	83.051	147	30	-1	-3	-1/-3
ENSG00000007968	ENSG00000112242	1.67e-76	84	82.143	69	15	2	1	2/1
ENSG00000162727	ENSG00000228198	0	313	92.971	291	22	1	2	1/2
ENSG00000116785	ENSG00000134365	0	154	90.909	140	14	-3	-2	-3/-2
ENSG00000196860	ENSG00000100575	1.71e-23	65	93.846	61	4	-1	1	-1/1
ENSG00000148513	ENSG00000180777	0	286	83.566	239	47	-1	-3	-1/-3
ENSG00000065491	ENSG00000054611	4.24e-60	50	82	41	9	3	2	3/2
ENSG00000065491	ENSG00000054611	4.26e-60	50	82	41	9	3	2	3/2
ENSG00000213648	ENSG00000261052	0	426	99.531	424	2	-1	-2	-1/-2
ENSG00000007341	ENSG00000134245	0	668	99.551	665	3	-2	3	-2/3
ENSG00000240224	ENSG00000243135	0	781	96.287	752	29	1	2	1/2
ENSG00000240224	ENSG00000244474	0	781	95.519	746	35	1	2	1/2
ENSG00000112175	ENSG00000101144	3.19e-171	115	83.478	96	19	1	3	1/3
ENSG00000213853	ENSG00000180979	4.18e-84	68	80.882	55	13	2	-3	2/-3
ENSG00000213853	ENSG00000180979	7.69e-67	68	80.882	55	13	-2	1	-2/1
ENSG00000175265	ENSG00000215252	0	258	100	258	0	-3	-1	-3/-1
ENSG00000175265	ENSG00000179938	1.94e-110	98	81.633	80	18	1	2	1/2
ENSG00000025800	ENSG00000196911	0	260	93.462	243	17	1	2	1/2
ENSG00000025800	ENSG00000196911	0	260	93.462	243	17	1	2	1/2
ENSG00000188153	ENSG00000187498	0	230	83.478	192	38	2	3	2/3
ENSG00000187140	ENSG00000186564	6.91e-63	104	91.346	95	9	1	2	1/2
ENSG00000116903	ENSG00000010072	3.29e-127	142	100	142	0	-3	2	-3/2
ENSG00000240038	ENSG00000243480	0	537	95.531	513	24	-2	-1	-2/-1
ENSG00000198692	ENSG00000173674	6.27e-48	91	90.11	82	9	-3	-1	-3/-1
ENSG00000164430	ENSG00000215193	1.14e-65	105	83.81	88	17	3	2	3/2
ENSG00000164430	ENSG00000136213	1.66e-72	99	82.828	82	17	3	-3	3/-3
ENSG00000116191	ENSG00000136828	0	212	82.547	175	37	3	2	3/2
ENSG00000124257	ENSG00000064601	2.14e-51	81	100	81	0	2	-2	2/-2
ENSG00000124257	ENSG00000064601	1.13e-47	81	100	81	0	-1	2	-1/2
ENSG00000181873	ENSG00000214029	8.28e-92	67	80.597	54	13	-2	-1	-2/-1
ENSG00000181873	ENSG00000198393	1.99e-81	80	80	64	16	3	-3	3/-3
ENSG00000162733	ENSG00000204580	7.08e-80	53	83.019	44	9	3	1	3/1
ENSG00000154380	ENSG00000175782	1.2e-98	98	80.612	79	19	-3	3	-3/3
ENSG00000221866	ENSG00000076356	0	726	81.818	594	132	1	3	1/3
ENSG00000172476	ENSG00000102128	0	242	98.347	238	4	2	3	2/3
ENSG00000095587	ENSG00000038295	0	65	83.077	54	11	-1	-3	-1/-3
ENSG00000183206	ENSG00000278522	0	362	97.514	353	9	-3	-1	-3/-1
ENSG00000183206	ENSG00000166351	0	536	96.455	517	19	1	2	1/2
ENSG00000184330	ENSG00000143556	8.5e-81	145	88.276	128	17	1	2	1/2
ENSG00000131503	ENSG00000254996	0	840	100	840	0	3	2	3/2
ENSG00000124177	ENSG00000171316	0	504	84.325	425	79	2	3	2/3
ENSG00000124177	ENSG00000100888	0	508	83.465	424	84	2	1	2/1
ENSG00000168765	ENSG00000134184	0	306	87.255	267	39	-3	-1	-3/-1
ENSG00000213714	ENSG00000124103	1.97e-127	228	90.351	206	22	1	3	1/3
ENSG00000148296	ENSG00000111275	2.91e-106	92	80.435	74	18	-1	1	-1/1
ENSG00000171345	ENSG00000128422	2.69e-82	113	80.531	91	22	-2	-3	-2/-3
ENSG00000143443	ENSG00000197622	1.54e-88	141	100	141	0	3	-1	3/-1
ENSG00000102030	ENSG00000156269	2.2199999999999998e-95	117	94.017	110	7	1	3	1/3
ENSG00000126804	ENSG00000089775	5.08e-50	69	100	69	0	-2	3	-2/3
ENSG00000119900	ENSG00000197343	1.56e-26	86	81.395	70	16	1	-1	1/-1
ENSG00000065243	ENSG00000123143	0	332	80.422	267	65	3	2	3/2
ENSG00000172260	ENSG00000180398	0	126	82.54	104	22	-3	-1	-3/-1
ENSG00000254685	ENSG00000259030	1.93e-81	135	94.815	128	7	2	3	2/3
ENSG00000157184	ENSG00000110090	1.06e-32	50	84	42	8	-1	1	-1/1
ENSG00000198889	ENSG00000198354	0	471	86.837	409	62	1	3	1/3
ENSG00000168264	ENSG00000119669	1.36e-73	56	85.714	48	8	-2	-3	-2/-3
ENSG00000198668	ENSG00000160014	1.25e-98	173	90.751	157	16	3	2	3/2
ENSG00000102359	ENSG00000102362	0	432	100	432	0	3	-1	3/-1
ENSG00000102359	ENSG00000102362	0	432	100	432	0	1	-2	1/-2
ENSG00000143252	ENSG00000136213	6.58e-177	99	81.818	81	18	1	-3	1/-3
ENSG00000084623	ENSG00000174165	6.21e-35	59	84.746	50	9	3	-3	3/-3
ENSG00000124103	ENSG00000213714	2.73e-115	228	90.351	206	22	3	1	3/1
ENSG00000196747	ENSG00000196787	2.06e-76	123	92.683	114	9	3	1	3/1
ENSG00000196747	ENSG00000233822	5.92e-74	109	99.083	108	1	3	-1	3/-1
ENSG00000147400	ENSG00000177143	5.88e-31	87	85.057	74	13	-3	-1	-3/-1
ENSG00000066382	ENSG00000186732	4.24e-175	286	81.119	232	54	1	2	1/2
ENSG00000198573	ENSG00000196406	2.3e-67	129	97.674	126	3	1	2	1/2
ENSG00000198573	ENSG00000198021	4e-62	129	96.124	124	5	-1	-2	-1/-2
ENSG00000092607	ENSG00000112837	7.54e-158	234	85.47	200	34	2	3	2/3
ENSG00000007341	ENSG00000134245	0	668	99.551	665	3	-2	3	-2/3
ENSG00000170074	ENSG00000182230	0	136	97.794	133	3	3	1	3/1
ENSG00000119318	ENSG00000179262	3.59e-104	54	92.593	50	4	1	2	1/2
ENSG00000168148	ENSG00000274750	2.28e-64	125	86.4	108	17	-3	-2	-3/-2
ENSG00000168148	ENSG00000278828	8.98e-79	127	96.85	123	4	1	2	1/2
ENSG00000197385	ENSG00000198346	0	69	85.507	59	10	1	3	1/3
ENSG00000197385	ENSG00000213799	0	122	81.148	99	23	-2	-3	-2/-3
ENSG00000148842	ENSG00000076685	0	528	100	528	0	1	-2	1/-2
ENSG00000148842	ENSG00000076685	0	528	100	528	0	1	-1	1/-1
ENSG00000151923	ENSG00000116001	0	247	86.235	213	34	1	3	1/3
ENSG00000167136	ENSG00000198917	1.98e-95	122	96.721	118	4	-3	2	-3/2
ENSG00000125484	ENSG00000125485	3.71e-68	122	100	122	0	2	-2	2/-2
ENSG00000125484	ENSG00000125485	3.71e-68	122	100	122	0	2	-1	2/-1
ENSG00000162367	ENSG00000104903	3.03e-30	62	85.484	53	9	1	2	1/2
ENSG00000101882	ENSG00000072958	1.52e-177	98	80.612	79	19	3	1	3/1
ENSG00000185303	ENSG00000122852	0	393	92.875	365	28	3	2	3/2
ENSG00000197852	ENSG00000126067	8.95e-50	87	85.057	74	13	2	1	2/1
ENSG00000162695	ENSG00000126070	2.13e-59	88	80.682	71	17	-1	2	-1/2
ENSG00000124615	ENSG00000146122	4.09e-155	237	100	237	0	3	-3	3/-3
ENSG00000124615	ENSG00000146122	5.19e-146	237	100	237	0	-1	3	-1/3
ENSG00000068383	ENSG00000148826	3.88e-63	100	100	100	0	1	-1	1/-1
ENSG00000068383	ENSG00000148826	1.9e-54	100	100	100	0	-1	1	-1/1
ENSG00000171357	ENSG00000085998	7.69e-138	199	100	199	0	3	-2	3/-2
ENSG00000139675	ENSG00000135486	3.03e-151	211	97.156	205	6	2	1	2/1
ENSG00000146221	ENSG00000178233	1.32e-145	234	100	234	0	2	-1	2/-1
ENSG00000197020	ENSG00000118620	0	591	80.88	478	113	-2	-1	-2/-1
ENSG00000181274	ENSG00000165879	7.17e-108	119	90.756	108	11	3	2	3/2
ENSG00000163817	ENSG00000170088	7.64e-130	73	83.562	61	12	1	-1	1/-1
ENSG00000112144	ENSG00000111837	0	305	83.934	256	49	2	1	2/1
ENSG00000174514	ENSG00000141576	3.65e-42	90	81.111	73	17	2	-3	2/-3
ENSG00000174514	ENSG00000141576	3.65e-42	90	81.111	73	17	2	-3	2/-3
ENSG00000197903	ENSG00000124635	1.45e-49	68	94.118	64	4	-2	-1	-2/-1
ENSG00000075407	ENSG00000196693	0	77	81.818	63	14	1	2	1/2
ENSG00000198914	ENSG00000196767	5.81e-58	81	80.247	65	16	-3	-1	-3/-1
ENSG00000116918	ENSG00000183049	2.94e-45	92	81.522	75	17	-1	-2	-1/-2
ENSG00000116918	ENSG00000269404	5.55e-45	92	81.522	75	17	-1	-2	-1/-2
ENSG00000204065	ENSG00000196507	8.18e-130	215	83.721	180	35	-3	-2	-3/-2
ENSG00000204065	ENSG00000196507	3.45e-131	215	83.721	180	35	-3	-1	-3/-1
ENSG00000162377	ENSG00000138592	2.25e-91	58	82.759	48	10	1	-1	1/-1
ENSG00000162377	ENSG00000198015	1.51e-37	51	80.392	41	10	2	3	2/3
ENSG00000131721	ENSG00000203989	0	401	100	401	0	-2	-3	-2/-3
ENSG00000143303	ENSG00000143319	6.62e-62	52	100	52	0	-2	1	-2/1
ENSG00000143303	ENSG00000143319	1.81e-49	52	100	52	0	1	-3	1/-3
ENSG00000116478	ENSG00000196591	0	437	90.618	396	41	1	3	1/3
ENSG00000167106	ENSG00000162636	2e-68	73	80.822	59	14	1	2	1/2
ENSG00000198205	ENSG00000198455	0	566	95.936	543	23	-3	-2	-3/-2
ENSG00000198205	ENSG00000070476	0	351	80.342	282	69	2	1	2/1
ENSG00000196911	ENSG00000162924	0	396	93.434	370	26	2	1	2/1
ENSG00000124157	ENSG00000124233	0	275	83.273	229	46	-3	-1	-3/-1
ENSG00000203722	ENSG00000131015	5.51e-129	222	88.288	196	26	1	3	1/3
ENSG00000203722	ENSG00000155918	2.7e-128	222	87.838	195	27	1	3	1/3
ENSG00000203722	ENSG00000155918	8.9e-128	222	87.838	195	27	-2	-1	-2/-1
ENSG00000117009	ENSG00000054277	0	504	100	504	0	-1	3	-1/3
ENSG00000196363	ENSG00000196981	0	320	87.188	279	41	1	2	1/2
ENSG00000126461	ENSG00000070047	2.37e-21	52	80.769	42	10	-2	-3	-2/-3
ENSG00000126461	ENSG00000070047	2.37e-21	52	80.769	42	10	-2	-3	-2/-3
ENSG00000054282	ENSG00000117020	1.76e-67	114	100	114	0	-1	1	-1/1
ENSG00000198642	ENSG00000003096	0	623	92.295	575	48	3	2	3/2
ENSG00000178761	ENSG00000178802	0	744	100	744	0	2	-2	2/-2
ENSG00000116497	ENSG00000180488	2.61e-46	76	82.895	63	13	3	-1	3/-1
ENSG00000171943	ENSG00000266028	0	340	98.235	334	6	3	2	3/2
ENSG00000173258	ENSG00000185219	1.08e-56	66	80.303	53	13	-2	-3	-2/-3
ENSG00000101181	ENSG00000141965	8.02e-58	56	82.143	46	10	3	1	3/1
ENSG00000196361	ENSG00000162374	0	221	90.045	199	22	3	1	3/1
ENSG00000254415	ENSG00000105501	1.74e-146	222	98.198	218	4	3	1	3/1
ENSG00000198894	ENSG00000120314	8.87e-42	80	85	68	12	-2	-1	-2/-1
ENSG00000198894	ENSG00000126070	2.78e-40	84	80.952	68	16	-2	3	-2/3
ENSG00000027644	ENSG00000140443	7.53e-120	98	81.633	80	18	-2	-3	-2/-3
ENSG00000027644	ENSG00000140443	3.96e-117	98	81.633	80	18	-2	-1	-2/-1
ENSG00000143105	ENSG00000111262	8.54e-151	152	84.868	129	23	2	1	2/1
ENSG00000143105	ENSG00000177272	7.11e-149	148	87.838	130	18	2	3	2/3
ENSG00000213397	ENSG00000183479	0	184	100	184	0	3	1	3/1
ENSG00000169474	ENSG00000169469	9.74e-33	60	93.333	56	4	2	1	2/1
ENSG00000143436	ENSG00000143450	9.84e-30	58	94.828	55	3	-3	2	-3/2
ENSG00000274791	ENSG00000277203	1.54e-136	136	100	136	0	1	3	1/3
ENSG00000274791	ENSG00000277150	1.45e-128	92	100	92	0	-1	-2	-1/-2
ENSG00000243284	ENSG00000188004	8.19e-47	91	98.901	90	1	2	1	2/1
ENSG00000243284	ENSG00000188004	8.19e-47	91	98.901	90	1	2	3	2/3
ENSG00000168612	ENSG00000108219	1.51e-73	93	82.796	77	16	2	-1	2/-1
ENSG00000198380	ENSG00000131459	0	446	81.166	362	84	1	3	1/3
ENSG00000029639	ENSG00000146426	4.57e-43	71	100	71	0	-2	3	-2/3
ENSG00000029639	ENSG00000146426	1.18e-42	71	100	71	0	1	-1	1/-1
ENSG00000029639	ENSG00000146426	9.33e-40	71	100	71	0	2	-2	2/-2
ENSG00000029639	ENSG00000146426	3.33e-39	71	100	71	0	-3	1	-3/1
ENSG00000029639	ENSG00000146426	7.36e-37	71	100	71	0	-1	2	-1/2
ENSG00000029639	ENSG00000146426	9.34e-36	71	100	71	0	3	-3	3/-3
ENSG00000029639	ENSG00000146426	4.57e-43	71	100	71	0	-2	3	-2/3
ENSG00000029639	ENSG00000146426	1.18e-42	71	100	71	0	1	-1	1/-1
ENSG00000029639	ENSG00000146426	9.33e-40	71	100	71	0	2	-2	2/-2
ENSG00000029639	ENSG00000146426	3.33e-39	71	100	71	0	-3	1	-3/1
ENSG00000029639	ENSG00000146426	7.36e-37	71	100	71	0	-1	2	-1/2
ENSG00000029639	ENSG00000146426	9.34e-36	71	100	71	0	3	-3	3/-3
ENSG00000168118	ENSG00000213029	2.4e-145	215	100	215	0	2	3	2/3
ENSG00000197360	ENSG00000229676	0	611	97.381	595	16	1	3	1/3
ENSG00000143858	ENSG00000077157	0	703	100	703	0	2	-2	2/-2
ENSG00000197837	ENSG00000158406	1.14e-60	83	100	83	0	3	2	3/2
ENSG00000180616	ENSG00000169609	1.03e-70	93	80.645	75	18	3	-2	3/-2
ENSG00000180616	ENSG00000175782	2.56e-155	93	81.72	76	17	-1	-2	-1/-2
ENSG00000130024	ENSG00000185127	3.76e-39	64	96.875	62	2	2	-1	2/-1
ENSG00000156150	ENSG00000180318	1.54e-50	85	84.706	72	13	2	3	2/3
ENSG00000097007	ENSG00000143322	0	470	88.298	415	55	3	1	3/1
ENSG00000077458	ENSG00000009780	1.75e-132	114	85.088	97	17	2	1	2/1
ENSG00000196313	ENSG00000272391	0	435	96.782	421	14	-3	-1	-3/-1
ENSG00000119285	ENSG00000116977	0	655	100	655	0	-3	1	-3/1
ENSG00000119285	ENSG00000116977	0	655	100	655	0	-3	3	-3/3
ENSG00000143436	ENSG00000143450	6.33e-30	58	94.828	55	3	-2	2	-2/2
ENSG00000127603	ENSG00000151914	0	188	83.511	157	31	2	1	2/1
ENSG00000066739	ENSG00000100744	1.35e-42	88	100	88	0	3	-1	3/-1
ENSG00000117222	ENSG00000138035	9.07e-63	87	82.759	72	15	-3	-1	-3/-1
ENSG00000240849	ENSG00000124208	2.48e-157	231	100	231	0	2	1	2/1
ENSG00000203989	ENSG00000131721	0	401	100	401	0	-3	-2	-3/-2
ENSG00000127124	ENSG00000010818	0	89	89.888	80	9	2	1	2/1
ENSG00000169760	ENSG00000165246	0	357	81.793	292	65	3	1	3/1
ENSG00000204071	ENSG00000196507	1.92e-164	82	95.122	78	4	-1	-2	-1/-2
ENSG00000150337	ENSG00000198019	0	198	98.99	196	2	-2	-1	-2/-1
ENSG00000150337	ENSG00000198019	6.13e-178	198	98.99	196	2	3	2	3/2
ENSG00000197724	ENSG00000172943	0	66	80.303	53	13	2	3	2/3
ENSG00000116726	ENSG00000204510	0	431	84.455	364	67	1	3	1/3
ENSG00000116726	ENSG00000204510	0	431	84.455	364	67	1	3	1/3
ENSG00000278828	ENSG00000203852	1.67e-86	137	99.27	136	1	2	1	2/1
ENSG00000278828	ENSG00000203811	1.67e-86	137	99.27	136	1	2	1	2/1
ENSG00000198380	ENSG00000131459	0	446	81.166	362	84	1	3	1/3
ENSG00000128335	ENSG00000100342	0	170	84.706	144	26	1	2	1/2
ENSG00000122136	ENSG00000171102	1.79e-142	229	94.323	216	13	-3	-2	-3/-2
ENSG00000101811	ENSG00000177613	0	216	86.111	186	30	2	1	2/1
ENSG00000203811	ENSG00000278828	2.31e-86	137	99.27	136	1	1	2	1/2
ENSG00000138161	ENSG00000213185	6.6e-74	119	95.798	114	5	2	3	2/3
ENSG00000198700	ENSG00000126070	1.15e-91	52	80.769	42	10	-3	-2	-3/-2
ENSG00000198700	ENSG00000175782	7.81e-134	87	80.46	70	17	-1	-2	-1/-2
ENSG00000197329	ENSG00000139946	0	411	81.752	336	75	3	2	3/2
ENSG00000163202	ENSG00000185966	9.95e-61	53	94.34	50	3	-1	-3	-1/-3
ENSG00000183431	ENSG00000100784	2.72e-38	55	80	44	11	-2	-1	-2/-1
ENSG00000137193	ENSG00000198355	2.7e-134	194	80.928	157	37	2	1	2/1
ENSG00000188786	ENSG00000188033	3.17e-63	60	83.333	50	10	2	3	2/3
ENSG00000188786	ENSG00000196172	1.61e-61	62	83.871	52	10	3	1	3/1
ENSG00000163216	ENSG00000241794	4.26e-108	160	89.375	143	17	2	1	2/1
ENSG00000196715	ENSG00000175782	3.42e-15	50	82	41	9	-1	-2	-1/-2
ENSG00000107317	ENSG00000284341	1.07e-145	211	100	211	0	3	2	3/2
ENSG00000186340	ENSG00000137801	0	259	83.012	215	44	2	1	2/1
ENSG00000101109	ENSG00000104375	0	303	91.419	277	26	3	2	3/2
ENSG00000102362	ENSG00000102359	0	432	100	432	0	1	-3	1/-3
ENSG00000102362	ENSG00000102359	0	432	100	432	0	-1	3	-1/3
ENSG00000102362	ENSG00000102359	0	432	100	432	0	-2	1	-2/1
ENSG00000165841	ENSG00000138109	0	518	90.541	469	49	2	1	2/1
ENSG00000165841	ENSG00000108242	0	80	87.5	70	10	-3	-1	-3/-1
ENSG00000171862	ENSG00000227268	1.32e-47	94	100	94	0	-3	1	-3/1
ENSG00000167984	ENSG00000162408	2.26e-59	56	80.357	45	11	2	1	2/1
ENSG00000198471	ENSG00000175077	2.46e-96	127	92.126	117	10	-1	-2	-1/-2
ENSG00000130827	ENSG00000114554	0	623	83.949	523	100	2	1	2/1
ENSG00000130827	ENSG00000076356	0	272	80.147	218	54	2	3	2/3
ENSG00000166913	ENSG00000164924	5.15e-134	239	85.774	205	34	2	1	2/1
ENSG00000264343	ENSG00000134250	2.86e-171	246	97.561	240	6	1	3	1/3
ENSG00000196693	ENSG00000189180	0	812	92.611	752	60	2	1	2/1
ENSG00000172339	ENSG00000175782	4.68e-40	50	82	41	9	-2	-3	-2/-3
ENSG00000172339	ENSG00000066427	2.24e-38	52	86.538	45	7	-3	2	-3/2
ENSG00000196475	ENSG00000198814	0	556	88.309	491	65	1	3	1/3
ENSG00000107854	ENSG00000173273	0	383	86.162	330	53	2	3	2/3
ENSG00000188004	ENSG00000158714	0	327	99.388	325	2	2	-1	2/-1
ENSG00000196411	ENSG00000182580	0	392	81.888	321	71	2	3	2/3
ENSG00000198830	ENSG00000126814	0	177	85.876	152	25	2	1	2/1
ENSG00000174876	ENSG00000187733	0	538	100	538	0	-3	-1	-3/-1
ENSG00000158615	ENSG00000166448	7.57e-40	85	80	68	17	2	-3	2/-3
ENSG00000158615	ENSG00000166448	7.57e-40	85	80	68	17	2	-3	2/-3
ENSG00000162385	ENSG00000111196	4.83e-97	148	98.649	146	2	1	2	1/2
ENSG00000242366	ENSG00000244122	0	426	92.019	392	34	-3	-1	-3/-1
ENSG00000242366	ENSG00000241119	0	646	98.452	636	10	1	2	1/2
ENSG00000186288	ENSG00000184388	0	269	99.257	267	2	-1	-3	-1/-3
ENSG00000171488	ENSG00000171017	0	90	84.444	76	14	1	2	1/2
ENSG00000171488	ENSG00000171017	0	90	84.444	76	14	1	3	1/3
ENSG00000173214	ENSG00000136213	6.11e-115	78	82.051	64	14	2	1	2/1
ENSG00000173214	ENSG00000136213	2.03e-104	78	82.051	64	14	3	2	3/2
ENSG00000173214	ENSG00000175387	9.51e-64	56	83.929	47	9	1	-3	1/-3
ENSG00000099284	ENSG00000113648	1.44e-151	116	84.483	98	18	1	2	1/2
ENSG00000272514	ENSG00000213204	0	666	100	666	0	2	3	2/3
ENSG00000143858	ENSG00000077157	0	703	100	703	0	3	-2	3/-2
ENSG00000096080	ENSG00000172426	4.84e-152	215	95.349	205	10	1	-2	1/-2
ENSG00000198874	ENSG00000277149	0	659	96.358	635	24	-3	-1	-3/-1
ENSG00000112406	ENSG00000010244	2.47e-37	89	80.899	72	17	-1	-3	-1/-3
ENSG00000112406	ENSG00000010244	4.67e-33	89	80.899	72	17	2	1	2/1
ENSG00000125356	ENSG00000125352	1.9e-73	113	100	113	0	1	-2	1/-2
ENSG00000125356	ENSG00000125352	3.32e-72	113	100	113	0	-3	1	-3/1
ENSG00000143355	ENSG00000106689	2.66e-147	84	91.667	77	7	3	2	3/2
ENSG00000197183	ENSG00000101746	2.59e-85	115	81.739	94	21	3	2	3/2
ENSG00000214435	ENSG00000270316	0	753	99.602	750	3	3	2	3/2
ENSG00000214435	ENSG00000134830	1.59e-91	62	82.258	51	11	1	2	1/2
ENSG00000196166	ENSG00000168067	3.67e-46	93	83.871	78	15	1	2	1/2
ENSG00000244122	ENSG00000242366	0	426	92.019	392	34	-1	-3	-1/-3
ENSG00000166136	ENSG00000255339	1.93e-155	215	100	215	0	2	1	2/1
ENSG00000112208	ENSG00000112210	0	790	100	790	0	1	-2	1/-2
ENSG00000116459	ENSG00000116455	1.47e-74	126	88.095	111	15	1	-3	1/-3
ENSG00000102144	ENSG00000170950	0	421	87.173	367	54	3	1	3/1
ENSG00000102144	ENSG00000140323	2.09e-72	79	81.013	64	15	-2	-1	-2/-1
ENSG00000089091	ENSG00000104205	2.13e-38	99	82.828	82	17	1	3	1/3
ENSG00000196550	ENSG00000215784	0	347	98.559	342	5	-1	-3	-1/-3
ENSG00000196550	ENSG00000263513	0	347	98.559	342	5	-1	-2	-1/-2
ENSG00000184388	ENSG00000186288	0	269	99.257	267	2	-3	-1	-3/-1
ENSG00000139218	ENSG00000167693	9.61e-48	69	86.957	60	9	-2	2	-2/2
ENSG00000139218	ENSG00000167693	9.63e-48	69	86.957	60	9	-2	1	-2/1
ENSG00000117228	ENSG00000117226	0	398	88.191	351	47	2	3	2/3
ENSG00000117228	ENSG00000162645	7.43e-168	92	83.696	77	15	-3	-1	-3/-1
ENSG00000143303	ENSG00000143319	9.29e-53	52	100	52	0	-1	1	-1/1
ENSG00000143303	ENSG00000143319	1.71e-41	52	100	52	0	1	-3	1/-3
ENSG00000054277	ENSG00000117009	0	504	100	504	0	3	-1	3/-1
ENSG00000054277	ENSG00000203668	2.9e-37	83	100	83	0	-3	-2	-3/-2
ENSG00000196236	ENSG00000215193	3.13e-122	98	80.612	79	19	1	2	1/2
ENSG00000196236	ENSG00000273274	5.92e-88	55	85.455	47	8	2	-1	2/-1
ENSG00000172572	ENSG00000152270	0	128	82.031	105	23	2	3	2/3
ENSG00000162409	ENSG00000132356	0	243	82.716	201	42	1	3	1/3
ENSG00000076356	ENSG00000221866	0	634	84.227	534	100	3	1	3/1
ENSG00000076356	ENSG00000221866	0	634	84.227	534	100	3	2	3/2
ENSG00000102076	ENSG00000269433	0	419	96.181	403	16	-3	-1	-3/-1
ENSG00000156875	ENSG00000148110	0	374	84.225	315	59	2	3	2/3
ENSG00000143768	ENSG00000243709	0	335	95.821	321	14	2	3	2/3
ENSG00000204632	ENSG00000206503	0	317	83.912	266	51	1	3	1/3
ENSG00000158764	ENSG00000179914	0	283	88.693	251	32	2	3	2/3
ENSG00000189064	ENSG00000236362	6.53e-95	127	99.213	126	1	3	2	3/2
ENSG00000189064	ENSG00000274274	5.01e-92	127	98.425	125	2	3	2	3/2
ENSG00000169905	ENSG00000100784	1.69e-115	51	82.353	42	9	3	-3	3/-3
ENSG00000169905	ENSG00000100784	1.24e-107	51	82.353	42	9	-3	2	-3/2
ENSG00000198021	ENSG00000196406	3.13e-109	214	83.645	179	35	-2	-1	-2/-1
ENSG00000187733	ENSG00000237763	0	538	100	538	0	-1	-3	-1/-3
ENSG00000187733	ENSG00000174876	0	537	100	537	0	-1	-3	-1/-3
ENSG00000197081	ENSG00000153721	1.67e-30	65	81.538	53	12	-1	2	-1/2
ENSG00000172426	ENSG00000096080	1.26e-151	215	95.349	205	10	-2	1	-2/1
ENSG00000156384	ENSG00000120314	3.04e-37	81	80.247	65	16	3	2	3/2
ENSG00000166984	ENSG00000203690	0	361	97.784	353	8	3	1	3/1
ENSG00000166984	ENSG00000242220	5.63e-95	92	81.522	75	17	-1	-3	-1/-3
ENSG00000160094	ENSG00000126746	6.17e-113	172	80.233	138	34	1	3	1/3
ENSG00000197465	ENSG00000250361	1.96e-30	65	92.308	60	5	-2	-3	-2/-3
ENSG00000143842	ENSG00000134532	3.17e-78	115	82.609	95	20	2	1	2/1
ENSG00000168925	ENSG00000168928	4.86e-158	154	96.104	148	6	-3	-1	-3/-1
ENSG00000148826	ENSG00000163623	7.98e-90	122	82.787	101	21	3	1	3/1
ENSG00000148826	ENSG00000068383	3.47e-63	100	100	100	0	-1	1	-1/1
ENSG00000148826	ENSG00000068383	1.7e-54	100	100	100	0	1	-1	1/-1
ENSG00000110680	ENSG00000175868	1.71e-68	80	88.75	71	9	-3	-1	-3/-1
ENSG00000185009	ENSG00000070718	0	426	83.333	355	71	2	1	2/1
ENSG00000204116	ENSG00000109220	2.24e-68	68	85.294	58	10	3	1	3/1
ENSG00000143156	ENSG00000143153	1.28e-37	64	100	64	0	2	-1	2/-1
ENSG00000143156	ENSG00000143153	6.28e-37	64	100	64	0	-1	2	-1/2
ENSG00000162390	ENSG00000167080	0	105	81.905	86	19	1	-2	1/-2
ENSG00000102038	ENSG00000153147	0	753	86.321	650	103	2	1	2/1
ENSG00000154079	ENSG00000101882	7.29e-45	63	80.952	51	12	-3	3	-3/3
ENSG00000065243	ENSG00000123143	0	332	80.422	267	65	3	2	3/2
ENSG00000112200	ENSG00000119820	1.25e-37	69	82.609	57	12	2	3	2/3
ENSG00000112200	ENSG00000273274	1.48e-60	71	81.69	58	13	2	3	2/3
ENSG00000242252	ENSG00000260238	1.25e-79	95	100	95	0	-3	-2	-3/-2
ENSG00000064655	ENSG00000104313	4.52e-144	67	80.597	54	13	3	2	3/2
ENSG00000188610	ENSG00000215784	0	460	98.261	452	8	-2	-3	-2/-3
ENSG00000188610	ENSG00000263513	0	159	98.742	157	2	-1	-3	-1/-3
ENSG00000108684	ENSG00000110881	0	160	85	136	24	1	2	1/2
ENSG00000221867	ENSG00000197172	0	466	96.996	452	14	2	3	2/3
ENSG00000198918	ENSG00000163923	2.62e-58	98	85.714	84	14	2	1	2/1
ENSG00000198354	ENSG00000198889	0	437	86.041	376	61	3	1	3/1
ENSG00000116984	ENSG00000136213	2.1e-41	55	81.818	45	10	-3	2	-3/2
ENSG00000213551	ENSG00000138286	2.27e-169	235	99.149	233	2	2	-1	2/-1
ENSG00000085998	ENSG00000171357	1.26e-137	199	100	199	0	-2	3	-2/3
ENSG00000167578	ENSG00000171570	1.07e-168	257	99.222	255	2	-1	-2	-1/-2
ENSG00000196199	ENSG00000143458	3.77e-63	93	80.645	75	18	2	1	2/1
ENSG00000196199	ENSG00000144815	1.68e-42	92	83.696	77	15	-2	2	-2/2
ENSG00000185668	ENSG00000198914	2.59e-62	142	91.549	130	12	-2	-3	-2/-3
ENSG00000198774	ENSG00000163428	1.68e-48	103	82.524	85	18	-2	3	-2/3
ENSG00000198774	ENSG00000171109	1.08e-47	60	83.333	50	10	-3	-1	-3/-1
ENSG00000125352	ENSG00000139797	7.87e-91	71	90.141	64	7	-1	-2	-1/-2
ENSG00000125352	ENSG00000125356	3.67e-73	113	100	113	0	-2	1	-2/1
ENSG00000120437	ENSG00000112096	0	278	99.281	276	2	2	-1	2/-1
ENSG00000120437	ENSG00000120438	1.74e-92	135	98.519	133	2	2	-2	2/-2
ENSG00000185966	ENSG00000163202	1.62e-59	63	95.238	60	3	-2	-3	-2/-3
ENSG00000248405	ENSG00000241484	0	269	100	269	0	3	1	3/1
ENSG00000248405	ENSG00000241484	0	269	100	269	0	3	1	3/1
ENSG00000149658	ENSG00000185728	0	182	86.264	157	25	1	3	1/3
ENSG00000149658	ENSG00000185728	0	182	86.264	157	25	1	3	1/3
ENSG00000171102	ENSG00000122136	1.8e-142	229	94.323	216	13	-2	-3	-2/-3
ENSG00000119185	ENSG00000151693	0	736	100	736	0	2	-1	2/-1
ENSG00000023909	ENSG00000162408	1.31e-56	58	82.759	48	10	2	-1	2/-1
ENSG00000278677	ENSG00000272196	2.62e-72	108	99.074	107	1	1	3	1/3
ENSG00000278677	ENSG00000203812	2.62e-72	108	99.074	107	1	1	3	1/3
ENSG00000196873	ENSG00000215126	0	560	99.286	556	4	3	2	3/2
ENSG00000196873	ENSG00000147996	0	597	99.33	593	4	-2	-1	-2/-1
ENSG00000067048	ENSG00000215301	0	493	95.132	469	24	1	3	1/3
ENSG00000197045	ENSG00000130755	3.84e-58	110	81.818	90	20	3	2	3/2
ENSG00000101204	ENSG00000120903	0	340	80.588	274	66	2	1	2/1
ENSG00000047410	ENSG00000116690	9.21e-131	116	100	116	0	-1	1	-1/1
ENSG00000047410	ENSG00000116690	9.8e-131	116	100	116	0	-1	1	-1/1
ENSG00000104818	ENSG00000267631	4.31e-113	169	98.817	167	2	2	1	2/1
ENSG00000104818	ENSG00000104827	8.39e-99	135	97.778	132	3	2	3	2/3
ENSG00000197959	ENSG00000079805	0	746	83.78	625	121	2	1	2/1
ENSG00000171116	ENSG00000268738	0	454	100	454	0	3	2	3/2
ENSG00000183305	ENSG00000268606	0	463	100	463	0	-1	-3	-1/-3
ENSG00000183305	ENSG00000268606	0	463	100	463	0	-1	-3	-1/-3
ENSG00000198865	ENSG00000250722	0	484	100	484	0	-2	1	-2/1
ENSG00000221838	ENSG00000166508	2.12e-42	87	87.356	76	11	-1	2	-1/2
ENSG00000168438	ENSG00000006638	4.44e-45	92	82.609	76	16	3	-1	3/-1
ENSG00000284741	ENSG00000128655	0	582	99.828	581	1	1	2	1/2
ENSG00000166275	ENSG00000270316	1.42e-68	115	100	115	0	2	1	2/1
ENSG00000162415	ENSG00000130449	0	193	86.01	166	27	3	1	3/1
ENSG00000123684	ENSG00000265491	1.05e-38	87	80.46	70	17	-3	3	-3/3
ENSG00000148219	ENSG00000122484	2.38e-168	148	84.459	125	23	2	-1	2/-1
ENSG00000148219	ENSG00000112096	0	148	85.135	126	22	-2	-3	-2/-3
ENSG00000213185	ENSG00000138161	1.45e-74	119	95.798	114	5	3	2	3/2
ENSG00000198740	ENSG00000114853	1.82e-176	245	93.878	230	15	2	3	2/3
ENSG00000196787	ENSG00000196747	1.19e-75	123	92.683	114	9	1	3	1/3
ENSG00000196787	ENSG00000272196	9.76e-71	108	99.074	107	1	1	3	1/3
ENSG00000117500	ENSG00000122483	2.91e-66	126	97.619	123	3	-1	2	-1/2
ENSG00000112837	ENSG00000092607	6.34e-159	252	80.952	204	48	3	2	3/2
ENSG00000112837	ENSG00000092607	1.48e-156	252	80.952	204	48	3	1	3/1
ENSG00000133641	ENSG00000198707	5.24e-67	120	100	120	0	-3	3	-3/3
ENSG00000180305	ENSG00000182931	9.22e-59	58	81.034	47	11	-2	-1	-2/-1
ENSG00000198019	ENSG00000150337	5.79e-179	196	98.98	194	2	1	3	1/3
ENSG00000160062	ENSG00000273274	1.71e-162	70	80	56	14	-2	-1	-2/-1
ENSG00000160062	ENSG00000273274	5.97e-123	70	80	56	14	-1	-3	-1/-3
ENSG00000116473	ENSG00000127314	4.75e-118	186	83.333	155	31	-2	-3	-2/-3
ENSG00000177551	ENSG00000171786	5.59e-16	55	98.182	54	1	2	3	2/3
ENSG00000177954	ENSG00000185088	8.2e-45	86	96.512	83	3	3	2	3/2
ENSG00000013392	ENSG00000173436	1.28e-38	83	81.928	68	15	1	-2	1/-2
ENSG00000213923	ENSG00000283900	0	438	100	438	0	1	2	1/2
ENSG00000198898	ENSG00000116489	2.09e-164	288	86.806	250	38	2	1	2/1
ENSG00000198898	ENSG00000100784	2.56e-114	96	83.333	80	16	-2	2	-2/2
ENSG00000196218	ENSG00000198626	0	122	87.705	107	15	1	3	1/3
ENSG00000135778	ENSG00000135749	3.82e-101	149	100	149	0	-1	3	-1/3
ENSG00000135778	ENSG00000135749	9.15e-100	149	100	149	0	2	-1	2/-1
ENSG00000135778	ENSG00000135749	5.25e-97	149	100	149	0	3	-2	3/-2
ENSG00000166160	ENSG00000269433	0	364	100	364	0	1	2	1/2
ENSG00000166160	ENSG00000268221	0	364	100	364	0	1	2	1/2
ENSG00000138316	ENSG00000156140	0	183	83.607	153	30	1	2	1/2
ENSG00000131015	ENSG00000155918	1.23e-154	244	90.164	220	24	-2	-1	-2/-1
ENSG00000198551	ENSG00000197647	1.77e-144	51	84.314	43	8	-3	-1	-3/-1
ENSG00000198551	ENSG00000197647	1.77e-144	51	84.314	43	8	-3	-2	-3/-2
ENSG00000107859	ENSG00000164093	3.4e-69	103	83.495	86	17	2	3	2/3
ENSG00000213029	ENSG00000168118	4.29e-146	215	100	215	0	3	2	3/2
ENSG00000025039	ENSG00000116954	0	336	87.798	295	41	2	1	2/1
ENSG00000221852	ENSG00000221880	2.14e-30	52	92.308	48	4	3	2	3/2
ENSG00000221852	ENSG00000188581	1.03e-31	52	94.231	49	3	3	2	3/2
ENSG00000196177	ENSG00000180398	7.01e-178	102	80.392	82	20	-2	-1	-2/-1
ENSG00000186376	ENSG00000162086	2.11e-103	66	81.818	54	12	-3	-1	-3/-1
ENSG00000204071	ENSG00000196507	2.05e-177	82	95.122	78	4	-1	-2	-1/-2
ENSG00000187180	ENSG00000187223	8.47e-65	64	93.75	60	4	-1	-2	-1/-2
ENSG00000187180	ENSG00000159455	3.07e-62	54	85.185	46	8	-1	-3	-1/-3
ENSG00000198074	ENSG00000227471	0	397	88.161	350	47	-2	-3	-2/-3
ENSG00000116191	ENSG00000136828	0	212	82.547	175	37	3	2	3/2
ENSG00000198546	ENSG00000130640	6.86e-61	93	100	93	0	-2	1	-2/1
ENSG00000198546	ENSG00000130640	6.86e-61	93	100	93	0	-2	1	-2/1
ENSG00000131019	ENSG00000111981	1.28e-71	88	87.5	77	11	-1	-2	-1/-2
ENSG00000125430	ENSG00000153976	4.09e-140	274	93.066	255	19	-3	-2	-3/-2
ENSG00000215271	ENSG00000215277	1.15e-133	198	98.99	196	2	3	-3	3/-3
ENSG00000215271	ENSG00000188295	7.84e-46	59	81.356	48	11	2	-2	2/-2
ENSG00000197013	ENSG00000213967	0	126	80.952	102	24	-2	-3	-2/-3
ENSG00000198917	ENSG00000167136	3.44e-92	122	96.721	118	4	2	-3	2/-3
ENSG00000157557	ENSG00000134954	9.56e-127	129	86.822	112	17	3	2	3/2
ENSG00000147224	ENSG00000229937	0	339	92.035	312	27	3	1	3/1
ENSG00000198961	ENSG00000181191	4.66e-114	129	89.922	116	13	1	2	1/2
ENSG00000213401	ENSG00000268606	0	415	84.578	351	64	-3	-1	-3/-1
ENSG00000203812	ENSG00000181218	1e-42	79	86.076	68	11	-3	-1	-3/-1
ENSG00000035687	ENSG00000185100	0	91	85.714	78	13	3	2	3/2
ENSG00000000971	ENSG00000244414	2.04e-169	217	94.47	205	12	-2	-1	-2/-1
ENSG00000000971	ENSG00000244414	2.12e-165	217	94.47	205	12	2	3	2/3
ENSG00000143179	ENSG00000130717	2.32e-113	67	83.582	56	11	1	2	1/2
ENSG00000143179	ENSG00000130717	8.9e-104	67	83.582	56	11	1	3	1/3
ENSG00000203923	ENSG00000204363	0	206	89.806	185	21	3	2	3/2
ENSG00000203923	ENSG00000268988	0	137	87.591	120	17	2	1	2/1
ENSG00000172288	ENSG00000172352	0	725	100	725	0	3	2	3/2
ENSG00000197213	ENSG00000131848	0	353	80.737	285	68	-1	-3	-1/-3
ENSG00000196944	ENSG00000182783	0	321	89.72	288	33	-1	-2	-1/-2
ENSG00000137413	ENSG00000175782	2.63e-134	90	82.222	74	16	3	2	3/2
ENSG00000137413	ENSG00000153721	5.22e-45	96	80.208	77	19	-1	-3	-1/-3
ENSG00000198626	ENSG00000198838	0	389	85.861	334	55	3	1	3/1
ENSG00000198626	ENSG00000196218	0	129	87.597	113	16	3	1	3/1
ENSG00000120314	ENSG00000256453	0	320	100	320	0	3	-1	3/-1
ENSG00000120314	ENSG00000175782	2.67e-82	87	80.46	70	17	2	-2	2/-2
ENSG00000120314	ENSG00000175782	5.01e-67	87	80.46	70	17	-1	2	-1/2
ENSG00000162645	ENSG00000117226	2.11e-174	94	88.298	83	11	-3	-1	-3/-1
ENSG00000214827	ENSG00000182712	5.09e-90	152	99.342	151	1	-1	-3	-1/-3
ENSG00000121933	ENSG00000282608	2.39e-98	164	98.78	162	2	-2	-1	-2/-1
ENSG00000116954	ENSG00000025039	0	336	87.798	295	41	1	2	1/2
ENSG00000121905	ENSG00000115756	2.4900000000000002e-123	196	94.388	185	11	1	3	1/3
ENSG00000152078	ENSG00000179364	1.32e-40	52	80.769	42	10	-3	3	-3/3
ENSG00000196277	ENSG00000179603	0	93	84.946	79	14	2	3	2/3
ENSG00000196277	ENSG00000179603	0	93	84.946	79	14	2	3	2/3
ENSG00000058673	ENSG00000257315	0	950	100	950	0	1	2	1/2
ENSG00000058673	ENSG00000257315	0	950	100	950	0	1	2	1/2
ENSG00000143324	ENSG00000138600	5.92e-41	86	80.233	69	17	3	2	3/2
ENSG00000116830	ENSG00000126070	2.49e-98	91	80.22	73	18	-1	-3	-1/-3
ENSG00000143355	ENSG00000106689	1.21e-146	84	91.667	77	7	1	2	1/2
ENSG00000198482	ENSG00000213799	0	205	80.488	165	40	1	3	1/3
ENSG00000198482	ENSG00000213799	0	205	80.488	165	40	1	3	1/3
ENSG00000075891	ENSG00000196092	2.78e-83	131	81.679	107	24	-1	-3	-1/-3
ENSG00000188931	ENSG00000143252	5.33e-122	142	99.296	141	1	-1	2	-1/2
ENSG00000134375	ENSG00000126768	5.95e-55	113	83.186	94	19	1	3	1/3
ENSG00000188828	ENSG00000145451	0	188	84.574	159	29	2	3	2/3
ENSG00000188828	ENSG00000145451	0	188	84.574	159	29	2	3	2/3
ENSG00000134698	ENSG00000092847	0	366	83.06	304	62	3	1	3/1
ENSG00000127125	ENSG00000066185	1.83e-29	50	100	50	0	2	-3	2/-3
ENSG00000127125	ENSG00000066185	6.52e-29	50	100	50	0	-3	1	-3/1
ENSG00000127125	ENSG00000066185	1.44e-22	50	100	50	0	-1	2	-1/2
ENSG00000112246	ENSG00000159263	0	359	86.072	309	50	1	2	1/2
ENSG00000066185	ENSG00000127125	3.61e-29	50	100	50	0	-3	2	-3/2
ENSG00000066185	ENSG00000127125	1.29e-28	50	100	50	0	1	-3	1/-3
ENSG00000066185	ENSG00000127125	2.85e-22	50	100	50	0	2	-1	2/-1
ENSG00000121481	ENSG00000204227	1.69e-123	151	84.106	127	24	1	2	1/2
ENSG00000198589	ENSG00000172915	0	175	80.571	141	34	2	1	2/1
ENSG00000165359	ENSG00000102786	0	245	84.49	207	38	2	3	2/3
ENSG00000124251	ENSG00000204070	7.93e-119	177	98.87	175	2	-2	2	-2/2
ENSG00000198355	ENSG00000137193	1.1e-129	183	81.967	150	33	1	2	1/2
ENSG00000184599	ENSG00000163377	5.67e-54	94	82.979	78	16	3	2	3/2
ENSG00000124249	ENSG00000101098	9.42e-112	168	100	168	0	2	-3	2/-3
ENSG00000124249	ENSG00000101098	6.34e-107	168	100	168	0	-1	3	-1/3
ENSG00000124249	ENSG00000101098	3.64e-100	168	100	168	0	-3	2	-3/2
ENSG00000196767	ENSG00000184486	2.06e-69	132	81.061	107	25	-1	-3	-1/-3
ENSG00000196767	ENSG00000198914	8.25e-65	135	82.222	111	24	-1	-3	-1/-3
ENSG00000169213	ENSG00000153721	4.1e-55	74	81.081	60	14	1	2	1/2
ENSG00000143458	ENSG00000119820	0	95	80	76	19	1	-2	1/-2
ENSG00000198326	ENSG00000188000	2.77e-29	72	83.333	60	12	-1	-2	-1/-2
ENSG00000143171	ENSG00000186350	7.54e-169	203	89.163	181	22	1	2	1/2
ENSG00000134253	ENSG00000185345	6.46e-38	53	84.906	45	8	3	-1	3/-1
ENSG00000173212	ENSG00000112096	4.6e-28	73	82.192	60	13	2	-2	2/-2
ENSG00000196946	ENSG00000215372	0	616	95.455	588	28	-2	-3	-2/-3
ENSG00000168264	ENSG00000119669	1.27e-73	56	85.714	48	8	-2	-3	-2/-3
ENSG00000198863	ENSG00000163428	4.62e-93	57	84.211	48	9	-1	-2	-1/-2
ENSG00000198863	ENSG00000231925	6.51e-92	101	81.188	82	19	-1	1	-1/1
ENSG00000204104	ENSG00000134830	3.82e-50	98	82.653	81	17	1	2	1/2
ENSG00000256980	ENSG00000135314	7.49e-97	133	83.459	111	22	3	1	3/1
ENSG00000056277	ENSG00000137871	0	209	85.167	178	31	2	1	2/1
ENSG00000164494	ENSG00000175782	1.66e-38	86	81.395	70	16	2	-2	2/-2
ENSG00000164494	ENSG00000174839	3.4e-43	96	81.25	78	18	-3	-1	-3/-1
ENSG00000163874	ENSG00000149289	2.16e-138	208	83.173	173	35	3	1	3/1
ENSG00000018625	ENSG00000163399	0	527	90.323	476	51	3	1	3/1
ENSG00000018625	ENSG00000163399	0	527	90.323	476	51	3	2	3/2
ENSG00000162430	ENSG00000181192	2.01e-37	61	80.328	49	12	1	-3	1/-3
ENSG00000169418	ENSG00000159899	0	368	80.435	296	72	2	1	2/1
ENSG00000165879	ENSG00000181274	6.86e-80	60	80	48	12	2	3	2/3
ENSG00000213281	ENSG00000174775	1.3e-100	193	84.456	163	30	3	2	3/2
ENSG00000096401	ENSG00000158270	1.22e-56	62	82.258	51	11	1	-1	1/-1
ENSG00000143549	ENSG00000140416	2.09e-105	88	93.182	82	6	2	3	2/3
ENSG00000148688	ENSG00000278129	4.16e-34	50	80	40	10	-1	2	-1/2
ENSG00000162365	ENSG00000187048	0	528	94.886	501	27	2	3	2/3
ENSG00000111642	ENSG00000116254	0	529	88.658	469	60	3	2	3/2
ENSG00000189013	ENSG00000243772	2.18e-180	104	86.538	90	14	2	3	2/3
ENSG00000167165	ENSG00000243135	0	305	98.689	301	4	3	2	3/2
ENSG00000242498	ENSG00000250021	2.79e-179	225	100	225	0	-1	-2	-1/-2
ENSG00000187223	ENSG00000187180	2.63e-38	64	93.75	60	4	-2	-1	-2/-1
ENSG00000187223	ENSG00000159455	2.83e-43	54	83.333	45	9	-2	-3	-2/-3
ENSG00000160716	ENSG00000117971	1.71e-58	65	81.538	53	12	3	1	3/1
ENSG00000280987	ENSG00000015479	0	727	100	727	0	3	1	3/1
ENSG00000280987	ENSG00000015479	0	727	100	727	0	3	1	3/1
ENSG00000134245	ENSG00000007341	0	668	99.551	665	3	3	-2	3/-2
ENSG00000127152	ENSG00000119866	0	114	87.719	100	14	2	1	2/1
ENSG00000086015	ENSG00000105613	0	540	82.222	444	96	2	1	2/1
ENSG00000086015	ENSG00000099308	0	376	80.851	304	72	2	1	2/1
ENSG00000154545	ENSG00000187243	0	612	100	612	0	2	1	2/1
ENSG00000126457	ENSG00000111218	0	339	81.711	277	62	1	2	1/2
ENSG00000156697	ENSG00000253797	0	266	90.602	241	25	-3	-2	-3/-2
ENSG00000145907	ENSG00000138757	2.06e-140	142	80.986	115	27	2	1	2/1
ENSG00000204397	ENSG00000137752	3.12e-81	134	92.537	124	10	-3	-2	-3/-2
ENSG00000161671	ENSG00000142530	3.53e-23	53	100	53	0	3	-2	3/-2
ENSG00000146267	ENSG00000261609	5.14e-41	93	81.72	76	17	-1	-2	-1/-2
ENSG00000146267	ENSG00000127311	8.96e-48	95	83.158	79	16	-3	-2	-3/-2
ENSG00000095951	ENSG00000127124	8.89e-178	69	81.159	56	13	3	2	3/2
ENSG00000095951	ENSG00000127124	1.02e-177	69	81.159	56	13	3	2	3/2
ENSG00000149476	ENSG00000162144	9.28e-104	166	100	166	0	2	-1	2/-1
ENSG00000149476	ENSG00000162144	3.06e-94	166	100	166	0	-1	2	-1/2
ENSG00000172650	ENSG00000204172	0	351	96.866	340	11	-3	-2	-3/-2
ENSG00000172650	ENSG00000204149	0	297	95.96	285	12	2	1	2/1
ENSG00000198083	ENSG00000239886	1.54e-121	102	94.118	96	6	-1	-2	-1/-2
ENSG00000198083	ENSG00000212659	2.17e-73	71	94.366	67	4	2	3	2/3
ENSG00000198502	ENSG00000196126	0	332	87.952	292	40	-1	-2	-1/-2
ENSG00000163283	ENSG00000163286	0	493	97.566	481	12	3	2	3/2
ENSG00000163283	ENSG00000163295	0	504	85.913	433	71	-1	-3	-1/-3
ENSG00000212710	ENSG00000150527	0	324	86.42	280	44	2	3	2/3
ENSG00000204657	ENSG00000204688	0	349	87.679	306	43	2	1	2/1
ENSG00000151468	ENSG00000123240	8.54e-28	58	87.931	51	7	3	-1	3/-1
ENSG00000197279	ENSG00000235109	1.68e-45	67	82.09	55	12	-2	-3	-2/-3
ENSG00000204590	ENSG00000204576	2.23e-60	96	100	96	0	-2	1	-2/1
ENSG00000205060	ENSG00000186300	8.45e-46	94	84.043	79	15	1	-1	1/-1
ENSG00000172780	ENSG00000261796	0	442	100	442	0	3	2	3/2
ENSG00000164330	ENSG00000221818	0	311	83.923	261	50	3	2	3/2
ENSG00000239306	ENSG00000248643	1.39e-84	143	100	143	0	-3	-2	-3/-2
ENSG00000138741	ENSG00000069018	0	422	84.123	355	67	3	2	3/2
ENSG00000165215	ENSG00000189143	1.92e-63	70	84.286	59	11	3	2	3/2
ENSG00000165215	ENSG00000189143	1.92e-63	70	84.286	59	11	3	2	3/2
ENSG00000196781	ENSG00000106829	0	360	96.667	348	12	1	3	1/3
ENSG00000196781	ENSG00000106829	0	360	96.667	348	12	1	2	1/2
ENSG00000120696	ENSG00000165572	0	653	81.93	535	118	-1	-3	-1/-3
ENSG00000066117	ENSG00000082014	0	105	80.952	85	20	3	2	3/2
ENSG00000081853	ENSG00000254245	0	412	100	412	0	2	3	2/3
ENSG00000198814	ENSG00000196475	0	457	85.339	390	67	-1	-3	-1/-3
ENSG00000186767	ENSG00000106723	1.18e-107	73	82.192	60	13	1	3	1/3
ENSG00000187175	ENSG00000221864	6.13e-87	108	83.333	90	18	1	2	1/2
ENSG00000134490	ENSG00000122484	7.7e-73	52	82.692	43	9	-1	3	-1/3
ENSG00000142634	ENSG00000115468	5.83e-64	130	84.615	110	20	3	1	3/1
ENSG00000188379	ENSG00000120235	1.59e-124	86	81.395	70	16	-2	-3	-2/-3
ENSG00000188379	ENSG00000197919	8.2e-104	54	81.481	44	10	1	2	1/2
ENSG00000135090	ENSG00000160551	0	350	83.143	291	59	3	1	3/1
ENSG00000215915	ENSG00000197785	0	290	87.586	254	36	3	2	3/2
ENSG00000215915	ENSG00000197785	0	290	87.586	254	36	3	2	3/2
ENSG00000221859	ENSG00000188155	2.6e-130	149	89.933	134	15	-2	-1	-2/-1
ENSG00000261052	ENSG00000213648	0	426	99.531	424	2	-2	-1	-2/-1
ENSG00000172352	ENSG00000172288	0	725	100	725	0	2	3	2/3
ENSG00000007923	ENSG00000041988	0	473	100	473	0	-1	2	-1/2
ENSG00000007923	ENSG00000041988	0	473	100	473	0	3	-1	3/-1
ENSG00000089057	ENSG00000170482	0	92	82.609	76	16	1	3	1/3
ENSG00000188493	ENSG00000265491	5.87e-43	55	85.455	47	8	-2	2	-2/2
ENSG00000239886	ENSG00000198083	2.26e-139	96	94.792	91	5	-2	-1	-2/-1
ENSG00000136937	ENSG00000167196	5.91e-49	98	84.694	83	15	2	-2	2/-2
ENSG00000177710	ENSG00000164729	0	184	92.935	171	13	-2	-1	-2/-1
ENSG00000177710	ENSG00000259224	0	404	93.317	377	27	3	2	3/2
ENSG00000246705	ENSG00000272196	1.54e-70	118	97.458	115	3	2	3	2/3
ENSG00000125944	ENSG00000135316	0	404	84.406	341	63	2	1	2/1
ENSG00000154265	ENSG00000154263	1.35e-36	76	100	76	0	2	1	2/1
ENSG00000184845	ENSG00000169676	1.52e-132	61	80.328	49	12	1	3	1/3
ENSG00000102317	ENSG00000126070	7.88e-53	69	81.159	56	13	-3	-1	-3/-1
ENSG00000213218	ENSG00000136488	2.12e-170	179	98.324	176	3	-1	-3	-1/-3
ENSG00000205710	ENSG00000108556	3.28e-179	67	100	67	0	-2	3	-2/3
ENSG00000205710	ENSG00000108556	8.93e-138	67	100	67	0	2	-1	2/-1
ENSG00000182583	ENSG00000205642	1.18e-173	129	93.023	120	9	-2	-1	-2/-1
ENSG00000182583	ENSG00000169059	4.65e-113	92	98.913	91	1	3	1	3/1
ENSG00000158286	ENSG00000169609	8.49e-67	77	81.818	63	14	-3	1	-3/1
ENSG00000158286	ENSG00000169609	2.61e-44	77	81.818	63	14	3	-2	3/-2
ENSG00000148459	ENSG00000136754	4.17e-40	68	100	68	0	-1	2	-1/2
ENSG00000148459	ENSG00000136754	3.56e-30	68	100	68	0	2	-1	2/-1
ENSG00000148459	ENSG00000136754	4.17e-40	68	100	68	0	-1	2	-1/2
ENSG00000148459	ENSG00000136754	3.56e-30	68	100	68	0	2	-1	2/-1
ENSG00000065029	ENSG00000166478	0	217	82.949	180	37	3	1	3/1
ENSG00000180376	ENSG00000163946	1.7e-52	90	98.889	89	1	1	-3	1/-3
ENSG00000169059	ENSG00000205642	0	165	97.576	161	4	-3	-2	-3/-2
ENSG00000169059	ENSG00000182583	1.39e-113	92	98.913	91	1	1	3	1/3
ENSG00000133983	ENSG00000258644	4.13e-85	131	100	131	0	-3	-1	-3/-1
ENSG00000164291	ENSG00000196459	9.77e-33	92	80.435	74	18	3	-3	3/-3
ENSG00000164291	ENSG00000196459	9.77e-33	92	80.435	74	18	3	-3	3/-3
ENSG00000122824	ENSG00000196368	3.65e-134	177	96.045	170	7	-3	-2	-3/-2
ENSG00000212659	ENSG00000239886	2.21e-134	127	94.488	120	7	-1	-2	-1/-2
ENSG00000212899	ENSG00000212900	3.5e-66	127	88.189	112	15	1	3	1/3
ENSG00000119737	ENSG00000270898	6.51e-22	56	96.429	54	2	-3	-1	-3/-1
ENSG00000205571	ENSG00000172062	0	192	100	192	0	3	1	3/1
ENSG00000221874	ENSG00000213799	0	218	82.11	179	39	3	1	3/1
ENSG00000221874	ENSG00000213799	0	218	82.11	179	39	3	1	3/1
ENSG00000144134	ENSG00000079974	0	241	98.755	238	3	3	2	3/2
ENSG00000205809	ENSG00000134545	0	162	90.123	146	16	1	2	1/2
ENSG00000244038	ENSG00000003402	1.94e-43	89	85.393	76	13	-2	3	-2/3
ENSG00000182768	ENSG00000112378	0	229	85.59	196	33	-3	-2	-3/-2
ENSG00000182768	ENSG00000153721	1.04e-133	64	82.812	53	11	2	-3	2/-3
ENSG00000205707	ENSG00000133703	7.25e-32	75	100	75	0	3	-1	3/-1
ENSG00000008196	ENSG00000137203	8.95e-146	217	86.636	188	29	2	3	2/3
ENSG00000008196	ENSG00000137203	4.11e-143	217	86.636	188	29	2	3	2/3
ENSG00000168283	ENSG00000269897	0	334	99.701	333	1	1	3	1/3
ENSG00000168283	ENSG00000277258	2.38e-123	142	82.394	117	25	2	1	2/1
ENSG00000178935	ENSG00000269343	0	197	93.401	184	13	-2	-1	-2/-1
ENSG00000178935	ENSG00000204514	0	196	93.367	183	13	3	2	3/2
ENSG00000158158	ENSG00000148842	0	276	82.609	228	48	3	2	3/2
ENSG00000142207	ENSG00000170262	5.2e-138	203	100	203	0	-2	2	-2/2
ENSG00000142207	ENSG00000170262	1.15e-127	203	100	203	0	2	-1	2/-1
ENSG00000142207	ENSG00000170262	5.2e-138	203	100	203	0	-2	3	-2/3
ENSG00000142207	ENSG00000170262	1.15e-127	203	100	203	0	2	-1	2/-1
ENSG00000205002	ENSG00000198863	3.8e-84	54	81.481	44	10	2	1	2/1
ENSG00000205002	ENSG00000273274	1.65e-82	93	80.645	75	18	-3	2	-3/2
ENSG00000205002	ENSG00000273274	9.14e-73	93	80.645	75	18	-2	1	-2/1
ENSG00000101940	ENSG00000175782	6.99e-103	52	80.769	42	10	-1	2	-1/2
ENSG00000204138	ENSG00000175782	2.03e-53	85	80	68	17	3	-1	3/-1
ENSG00000139496	ENSG00000148297	2.68e-43	61	81.967	50	11	-3	-2	-3/-2
ENSG00000147123	ENSG00000182872	2.27e-124	174	100	174	0	1	-1	1/-1
ENSG00000147123	ENSG00000182872	8.25e-117	174	100	174	0	2	-2	2/-2
ENSG00000205863	ENSG00000240654	0	297	97.306	289	8	1	3	1/3
ENSG00000205863	ENSG00000240654	0	297	97.306	289	8	1	3	1/3
ENSG00000204887	ENSG00000188581	1.32e-31	51	92.157	47	4	3	2	3/2
ENSG00000204887	ENSG00000188581	3.83e-27	51	92.157	47	4	-3	-1	-3/-1
ENSG00000204887	ENSG00000221880	3.43e-31	51	90.196	46	5	3	2	3/2
ENSG00000204887	ENSG00000221880	1.97e-24	51	90.196	46	5	-3	-1	-3/-1
ENSG00000204390	ENSG00000204388	0	612	91.503	560	52	2	1	2/1
ENSG00000204390	ENSG00000204389	0	612	91.503	560	52	2	3	2/3
ENSG00000160049	ENSG00000166233	5.72e-76	65	83.077	54	11	2	3	2/3
ENSG00000204576	ENSG00000204590	6.42e-61	96	100	96	0	1	-2	1/-2
ENSG00000283374	ENSG00000206483	1.02e-143	207	100	207	0	1	2	1/2
ENSG00000283374	ENSG00000197763	1.25e-78	134	96.269	129	5	-1	-2	-1/-2
ENSG00000074356	ENSG00000177225	1.15e-93	81	82.716	67	14	-1	-3	-1/-3
ENSG00000074356	ENSG00000177225	1.65e-93	81	82.716	67	14	-1	-3	-1/-3
ENSG00000116771	ENSG00000177225	1.23e-82	77	80.519	62	15	2	1	2/1
ENSG00000204335	ENSG00000105866	1.9e-60	88	87.5	77	11	1	3	1/3
ENSG00000147206	ENSG00000269437	2.69e-96	147	82.993	122	25	-1	-3	-1/-3
ENSG00000147206	ENSG00000269437	2.11e-96	147	82.993	122	25	-1	-2	-1/-2
ENSG00000155034	ENSG00000204531	1.78e-47	97	83.505	81	16	1	-1	1/-1
ENSG00000155034	ENSG00000204531	1.78e-47	97	83.505	81	16	1	-2	1/-2
ENSG00000215126	ENSG00000196873	0	560	99.286	556	4	2	3	2/3
ENSG00000215126	ENSG00000147996	0	597	98.827	590	7	-2	-1	-2/-1
ENSG00000204231	ENSG00000186350	4.61e-131	117	91.453	107	10	1	2	1/2
ENSG00000166233	ENSG00000072958	0	52	84.615	44	8	1	-1	1/-1
ENSG00000166233	ENSG00000198393	1.43e-128	65	83.077	54	11	3	2	3/2
ENSG00000165186	ENSG00000130818	1.07e-65	55	81.818	45	10	1	-2	1/-2
ENSG00000241484	ENSG00000248405	0	269	100	269	0	1	3	1/3
ENSG00000255221	ENSG00000137752	3.05e-74	119	82.353	98	21	2	3	2/3
ENSG00000205086	ENSG00000134539	9.2e-63	63	84.127	53	10	-3	1	-3/1
ENSG00000205086	ENSG00000134539	1.3e-62	63	84.127	53	10	-3	2	-3/2
ENSG00000165572	ENSG00000120696	0	350	88.571	310	40	3	2	3/2
ENSG00000184908	ENSG00000186510	0	687	91.266	627	60	1	2	1/2
ENSG00000205177	ENSG00000085063	6.73e-32	53	100	53	0	-2	-1	-2/-1
ENSG00000205177	ENSG00000085063	1.08e-29	53	100	53	0	-3	-2	-3/-2
ENSG00000197620	ENSG00000197021	0	263	96.578	254	9	-1	-2	-1/-2
ENSG00000174130	ENSG00000174125	0	315	86.349	272	43	3	2	3/2
ENSG00000278224	ENSG00000124593	0	279	100	279	0	1	3	1/3
ENSG00000168970	ENSG00000243708	0	470	100	470	0	1	2	1/2
ENSG00000204308	ENSG00000138942	3.8e-63	92	81.522	75	17	3	1	3/1
ENSG00000204308	ENSG00000138942	3.81e-63	92	81.522	75	17	3	1	3/1
ENSG00000134873	ENSG00000134874	0	519	100	519	0	-2	3	-2/3
ENSG00000278705	ENSG00000158406	2.68e-47	78	100	78	0	1	2	1/2
ENSG00000278705	ENSG00000158406	2.7e-47	78	100	78	0	1	3	1/3
ENSG00000172785	ENSG00000136682	0	597	98.66	589	8	-2	-1	-2/-1
ENSG00000172785	ENSG00000196873	0	560	98.036	549	11	2	3	2/3
ENSG00000165443	ENSG00000148541	0	537	100	537	0	-3	1	-3/1
ENSG00000165443	ENSG00000148541	0	537	100	537	0	2	-2	2/-2
ENSG00000107485	ENSG00000179348	1.57e-115	118	94.068	111	7	2	1	2/1
ENSG00000205718	ENSG00000237247	3.09e-179	257	99.222	255	2	-3	-1	-3/-1
ENSG00000172716	ENSG00000154760	0	62	80.645	50	12	3	2	3/2
ENSG00000175066	ENSG00000138592	5.13e-82	55	80	44	11	1	2	1/2
ENSG00000175066	ENSG00000153721	2.4e-117	71	80.282	57	14	3	-3	3/-3
ENSG00000206527	ENSG00000105392	1.25e-52	101	84.158	85	16	2	3	2/3
ENSG00000173068	ENSG00000169594	0	80	87.5	70	10	2	3	2/3
ENSG00000173068	ENSG00000169594	0	80	87.5	70	10	2	3	2/3
ENSG00000216649	ENSG00000227488	1.86e-107	172	100	172	0	1	2	1/2
ENSG00000216649	ENSG00000237671	1.86e-107	172	100	172	0	1	2	1/2
ENSG00000111262	ENSG00000177301	0	156	91.026	142	14	1	2	1/2
ENSG00000204352	ENSG00000048828	2.42e-94	160	88.125	141	19	3	1	3/1
ENSG00000121281	ENSG00000166164	0	726	100	726	0	-2	1	-2/1
ENSG00000169621	ENSG00000169618	0	241	100	241	0	-2	-3	-2/-3
ENSG00000166200	ENSG00000146281	1.07e-85	132	82.576	109	23	3	1	3/1
ENSG00000166263	ENSG00000253731	4.84e-52	57	92.982	53	4	-2	-1	-2/-1
ENSG00000166263	ENSG00000106460	1.54e-50	57	91.228	52	5	-2	3	-2/3
ENSG00000227057	ENSG00000204220	1.38e-45	75	100	75	0	1	-2	1/-2
ENSG00000227057	ENSG00000204220	5.32e-42	75	100	75	0	-3	1	-3/1
ENSG00000227057	ENSG00000204220	1.38e-41	75	100	75	0	-1	2	-1/2
ENSG00000227057	ENSG00000204220	4.91e-37	75	100	75	0	2	-3	2/-3
ENSG00000205730	ENSG00000173889	2.38e-96	51	80.392	41	10	1	2	1/2
ENSG00000072401	ENSG00000131508	1.83e-95	172	80.814	139	33	3	1	3/1
ENSG00000204152	ENSG00000265354	3.28e-142	225	96.889	218	7	1	3	1/3
ENSG00000188611	ENSG00000204147	0	741	98.516	730	11	-3	-2	-3/-2
ENSG00000134308	ENSG00000166913	7.36e-127	229	83.406	191	38	3	2	3/2
ENSG00000205922	ENSG00000169856	5e-94	155	88.387	137	18	1	3	1/3
ENSG00000205922	ENSG00000119547	5.31e-92	155	89.677	139	16	1	3	1/3
ENSG00000145945	ENSG00000071859	1.15e-139	148	85.811	127	21	1	3	1/3
ENSG00000183304	ENSG00000177138	1.11e-151	92	94.565	87	5	-2	-3	-2/-3
ENSG00000212807	ENSG00000221970	0	311	100	311	0	1	2	1/2
ENSG00000148110	ENSG00000156875	0	374	84.225	315	59	3	2	3/2
ENSG00000204479	ENSG00000187545	0	489	86.912	425	64	-2	-3	-2/-3
ENSG00000213401	ENSG00000268606	0	415	84.578	351	64	-3	-1	-3/-1
ENSG00000188312	ENSG00000127080	0	446	100	446	0	3	-2	3/-2
ENSG00000205250	ENSG00000133740	8.06e-86	80	92.5	74	6	3	2	3/2
ENSG00000205250	ENSG00000133740	1.16e-85	80	92.5	74	6	3	2	3/2
ENSG00000147059	ENSG00000186787	0	383	95.039	364	19	1	2	1/2
ENSG00000152463	ENSG00000171109	1.54e-43	86	84.884	73	13	2	-2	2/-2
ENSG00000152192	ENSG00000091010	1.32e-117	163	89.571	146	17	1	3	1/3
ENSG00000152192	ENSG00000151615	1.53e-102	158	93.038	147	11	1	3	1/3
ENSG00000137634	ENSG00000095110	6.38e-172	217	81.567	177	40	-2	-3	-2/-3
ENSG00000146038	ENSG00000146049	2.41e-123	199	99.497	198	1	2	-3	2/-3
ENSG00000135018	ENSG00000188021	0	163	90.184	147	16	3	2	3/2
ENSG00000159692	ENSG00000175029	0	309	88.997	275	34	2	3	2/3
ENSG00000170456	ENSG00000184014	0	101	82.178	83	18	2	1	2/1
ENSG00000142541	ENSG00000167065	7.01e-23	51	86.275	44	7	2	1	2/1
ENSG00000212721	ENSG00000204880	0	145	93.103	135	10	-1	-3	-1/-3
ENSG00000212721	ENSG00000212722	2.23e-121	132	84.848	112	20	-1	-2	-1/-2
ENSG00000185670	ENSG00000273274	7.94e-66	55	81.818	45	10	-3	-1	-3/-1
ENSG00000180758	ENSG00000175782	9.53e-87	89	80.899	72	17	-3	-1	-3/-1
ENSG00000180758	ENSG00000183196	4.28e-61	51	80.392	41	10	2	-1	2/-1
ENSG00000116198	ENSG00000170088	3.29e-114	70	80	56	14	-1	-3	-1/-3
ENSG00000116198	ENSG00000170088	2.1e-76	70	80	56	14	3	1	3/1
ENSG00000213214	ENSG00000050327	0	389	99.486	387	2	3	2	3/2
ENSG00000188312	ENSG00000127080	0	446	100	446	0	2	-2	2/-2
ENSG00000204779	ENSG00000184659	0	407	99.017	403	4	2	1	2/1
ENSG00000204779	ENSG00000187559	0	165	98.788	163	2	-2	-3	-2/-3
ENSG00000165059	ENSG00000072062	0	364	81.593	297	67	1	3	1/3
ENSG00000169914	ENSG00000141759	4.21e-50	95	82.105	78	17	3	-2	3/-2
ENSG00000169914	ENSG00000141759	2.41e-35	95	82.105	78	17	-1	1	-1/1
ENSG00000169914	ENSG00000187486	3.32e-35	98	81.633	80	18	-1	-2	-1/-2
ENSG00000090659	ENSG00000104938	4.67e-157	58	82.759	48	10	-1	-2	-1/-2
ENSG00000198176	ENSG00000183434	0	99	80.808	80	19	3	1	3/1
ENSG00000198176	ENSG00000114126	6.15e-119	100	86	86	14	3	1	3/1
ENSG00000106723	ENSG00000204271	4.05e-142	230	86.957	200	30	3	1	3/1
ENSG00000106723	ENSG00000204271	4.05e-142	230	86.957	200	30	3	1	3/1
ENSG00000071859	ENSG00000145945	1.38e-119	139	87.77	122	17	3	1	3/1
ENSG00000169955	ENSG00000261459	0	299	100	299	0	2	3	2/3
ENSG00000204147	ENSG00000188611	0	741	98.516	730	11	-2	-3	-2/-3
ENSG00000131737	ENSG00000006059	0	386	91.192	352	34	2	1	2/1
ENSG00000131737	ENSG00000094796	0	387	90.439	350	37	2	3	2/3
ENSG00000161010	ENSG00000161011	6.76e-145	207	100	207	0	3	-1	3/-1
ENSG00000161010	ENSG00000161011	1.01e-141	207	100	207	0	2	-3	2/-3
ENSG00000161010	ENSG00000161011	1.38e-121	207	100	207	0	-1	2	-1/2
ENSG00000213462	ENSG00000152926	7.83e-33	76	100	76	0	2	1	2/1
ENSG00000213462	ENSG00000152926	1.48e-32	76	100	76	0	-1	-3	-1/-3
ENSG00000108468	ENSG00000122565	1.42e-59	67	86.567	58	9	2	3	2/3
ENSG00000005156	ENSG00000092871	0	867	100	867	0	1	-2	1/-2
ENSG00000005156	ENSG00000092871	0	867	100	867	0	-2	1	-2/1
ENSG00000183474	ENSG00000145736	0	392	99.49	390	2	-2	-3	-2/-3
ENSG00000004848	ENSG00000052850	1.99e-31	66	83.333	55	11	2	3	2/3
ENSG00000114391	ENSG00000213047	3.24e-15	65	80	52	13	-2	2	-2/2
ENSG00000043355	ENSG00000152977	7.71e-125	204	84.314	172	32	-1	-2	-1/-2
ENSG00000043355	ENSG00000156925	9.42e-136	168	89.881	151	17	3	2	3/2
ENSG00000165028	ENSG00000136783	0	309	87.055	269	40	3	1	3/1
ENSG00000073464	ENSG00000109572	0	536	80.224	430	106	2	3	2/3
ENSG00000151657	ENSG00000169213	1.21e-83	59	98.305	58	1	-3	2	-3/2
ENSG00000090889	ENSG00000226650	0	698	89.828	627	71	1	3	1/3
ENSG00000137135	ENSG00000159884	2.09e-175	249	94.378	235	14	2	-3	2/-3
ENSG00000057608	ENSG00000203879	0	218	89.908	196	22	1	3	1/3
ENSG00000134551	ENSG00000231887	9.12e-72	110	94.545	104	6	1	2	1/2
ENSG00000186818	ENSG00000104972	0	176	82.955	146	30	1	3	1/3
ENSG00000107338	ENSG00000138606	4.87e-78	60	80	48	12	3	1	3/1
ENSG00000135945	ENSG00000158417	3.55e-180	284	100	284	0	1	-1	1/-1
ENSG00000116663	ENSG00000132879	9.31e-32	52	84.615	44	8	-2	2	-2/2
ENSG00000116663	ENSG00000132879	9.32e-32	52	84.615	44	8	-2	3	-2/3
ENSG00000070476	ENSG00000198455	0	311	85.209	265	46	1	2	1/2
ENSG00000240871	ENSG00000212722	5.48e-141	53	81.132	43	10	-1	-3	-1/-3
ENSG00000240871	ENSG00000204880	6.04e-87	127	80.315	102	25	-1	-2	-1/-2
ENSG00000121335	ENSG00000251655	1.09e-148	142	97.183	138	4	2	1	2/1
ENSG00000125835	ENSG00000128739	3.45e-93	100	97	97	3	2	3	2/3
ENSG00000147050	ENSG00000183878	0	408	88.725	362	46	3	1	3/1
ENSG00000161011	ENSG00000161010	2.23e-144	207	100	207	0	-1	3	-1/3
ENSG00000161011	ENSG00000161010	3.32e-141	207	100	207	0	-3	2	-3/2
ENSG00000147885	ENSG00000234829	6.91e-168	269	86.245	232	37	-3	-1	-3/-1
ENSG00000147885	ENSG00000186803	2.09e-154	261	87.356	228	33	1	2	1/2
ENSG00000186766	ENSG00000168269	7.37e-58	98	88.776	87	11	1	2	1/2
ENSG00000186766	ENSG00000214336	1.91e-57	98	87.755	86	12	1	2	1/2
ENSG00000168961	ENSG00000170298	0	261	90.421	236	25	1	2	1/2
ENSG00000120235	ENSG00000233816	4.66e-119	233	80.687	188	45	-3	-2	-3/-2
ENSG00000120235	ENSG00000188379	8.16e-105	86	81.395	70	16	-3	-2	-3/-2
ENSG00000205497	ENSG00000205496	0	314	96.815	304	10	3	1	3/1
ENSG00000090061	ENSG00000205476	0	447	100	447	0	2	-3	2/-3
ENSG00000119715	ENSG00000196482	0	366	81.421	298	68	3	2	3/2
ENSG00000050393	ENSG00000198393	1.05e-69	54	81.481	44	10	-3	-1	-3/-1
ENSG00000181634	ENSG00000273274	2.94e-57	55	83.636	46	9	1	2	1/2
ENSG00000205927	ENSG00000177468	3.33e-60	93	84.946	79	14	2	3	2/3
ENSG00000041988	ENSG00000007923	0	473	100	473	0	2	-1	2/-1
ENSG00000041988	ENSG00000007923	0	473	100	473	0	-1	3	-1/3
ENSG00000205029	ENSG00000186119	4.44e-160	304	81.25	247	57	1	3	1/3
ENSG00000147996	ENSG00000215126	0	207	98.068	203	4	1	2	1/2
ENSG00000118922	ENSG00000109787	2.94e-59	92	92.391	85	7	1	3	1/3
ENSG00000184659	ENSG00000204779	0	407	99.017	403	4	1	2	1/2
ENSG00000184659	ENSG00000273514	0	236	98.305	232	4	1	3	1/3
ENSG00000164117	ENSG00000164118	2.85e-49	90	98.889	89	1	-3	3	-3/3
ENSG00000164117	ENSG00000164118	5.39e-49	90	98.889	89	1	3	-1	3/-1
ENSG00000185130	ENSG00000274290	1.41e-52	97	82.474	80	17	1	3	1/3
ENSG00000185130	ENSG00000274290	7.86e-51	97	82.474	80	17	1	3	1/3
ENSG00000240682	ENSG00000261796	8.79e-170	303	100	303	0	2	3	2/3
ENSG00000213139	ENSG00000113838	1.16e-65	103	100	103	0	-3	-1	-3/-1
ENSG00000213139	ENSG00000113838	7.22e-64	103	100	103	0	-1	-2	-1/-2
ENSG00000213139	ENSG00000113838	9.92e-64	103	100	103	0	-2	-3	-2/-3
ENSG00000168175	ENSG00000135679	3.88e-66	50	80	40	10	3	2	3/2
ENSG00000163806	ENSG00000171103	4.16e-99	132	100	132	0	1	-2	1/-2
ENSG00000163806	ENSG00000171103	1.55e-95	132	100	132	0	-3	1	-3/1
ENSG00000184497	ENSG00000125355	1.92e-58	82	80.488	66	16	1	3	1/3
ENSG00000184497	ENSG00000125355	3.61e-54	82	80.488	66	16	1	2	1/2
ENSG00000187268	ENSG00000177138	3.67e-86	55	81.818	45	10	-2	-3	-2/-3
ENSG00000205143	ENSG00000116017	3.02e-81	133	84.962	113	20	1	3	1/3
ENSG00000170122	ENSG00000184492	0	358	94.413	338	20	2	3	2/3
ENSG00000170122	ENSG00000187559	0	273	95.604	261	12	2	1	2/1
ENSG00000168255	ENSG00000267645	0	294	98.98	291	3	-3	-2	-3/-2
ENSG00000168255	ENSG00000267368	0	165	99.394	164	1	-1	-3	-1/-3
ENSG00000159885	ENSG00000178386	0	64	82.812	53	11	-1	-3	-1/-3
ENSG00000180138	ENSG00000113712	0	334	81.138	271	63	2	3	2/3
ENSG00000223609	ENSG00000244734	2.29e-87	161	85.093	137	24	-1	-3	-1/-3
ENSG00000085231	ENSG00000273841	5.38e-23	61	95.082	58	3	1	2	1/2
ENSG00000243207	ENSG00000130810	0	312	100	312	0	1	2	1/2
ENSG00000205810	ENSG00000205809	3.07e-141	160	91.875	147	13	1	2	1/2
ENSG00000152463	ENSG00000136213	2.18e-48	86	81.395	70	16	1	3	1/3
ENSG00000113522	ENSG00000124783	1.23e-35	55	81.818	45	10	2	-3	2/-3
ENSG00000129873	ENSG00000182415	0	651	100	651	0	-2	-1	-2/-1
ENSG00000129873	ENSG00000172352	0	395	97.722	386	9	-2	-1	-2/-1
ENSG00000205089	ENSG00000164402	1.45e-72	73	98.63	72	1	-2	2	-2/2
ENSG00000011052	ENSG00000243678	1.11e-138	210	96.667	203	7	3	1	3/1
ENSG00000204856	ENSG00000111231	6.02e-53	87	96.552	84	3	-3	3	-3/3
ENSG00000212722	ENSG00000240871	3.41e-160	53	81.132	43	10	-3	-1	-3/-1
ENSG00000212722	ENSG00000212721	2.61e-130	132	84.848	112	20	-2	-1	-2/-1
ENSG00000168065	ENSG00000197891	1.75e-18	55	92.727	51	4	3	2	3/2
ENSG00000206047	ENSG00000240247	1.03e-68	121	100	121	0	2	3	2/3
ENSG00000069812	ENSG00000181192	3.74e-65	53	83.019	44	9	2	3	2/3
ENSG00000165023	ENSG00000176490	4.64e-93	129	84.496	109	20	1	2	1/2
ENSG00000183049	ENSG00000134072	0	309	84.79	262	47	3	2	3/2
ENSG00000173575	ENSG00000153922	0	531	85.687	455	76	1	2	1/2
ENSG00000196368	ENSG00000122824	8.64e-139	180	93.333	168	12	-2	-3	-2/-3
ENSG00000196368	ENSG00000122824	2.41e-126	180	93.333	168	12	-2	-3	-2/-3
ENSG00000125144	ENSG00000205358	3.96e-53	78	80.769	63	15	-2	-1	-2/-1
ENSG00000183753	ENSG00000185894	9.97e-69	107	100	107	0	-1	-2	-1/-2
ENSG00000183753	ENSG00000185894	2.59e-68	107	100	107	0	1	3	1/3
ENSG00000158373	ENSG00000180596	2.05e-65	118	92.373	109	9	1	2	1/2
ENSG00000205476	ENSG00000090061	0	447	100	447	0	-3	2	-3/2
ENSG00000132950	ENSG00000121741	1.44e-116	105	81.905	86	19	-2	-1	-2/-1
ENSG00000172780	ENSG00000261796	0	442	100	442	0	3	2	3/2
ENSG00000212122	ENSG00000100056	6.09e-154	277	82.31	228	49	1	-3	1/-3
ENSG00000212122	ENSG00000206203	6.1e-154	277	82.31	228	49	1	2	1/2
ENSG00000165556	ENSG00000113722	4.17e-41	71	90.141	64	7	1	2	1/2
ENSG00000197162	ENSG00000267041	7.76e-149	54	85.185	46	8	3	2	3/2
ENSG00000213886	ENSG00000204681	2.64e-164	246	98.374	242	4	2	3	2/3
ENSG00000205944	ENSG00000187191	0	501	96.008	481	20	1	2	1/2
ENSG00000241978	ENSG00000157654	0	907	100	907	0	1	3	1/3
ENSG00000101200	ENSG00000101405	2.95e-54	107	80.374	86	21	-1	-2	-1/-2
ENSG00000124784	ENSG00000164304	1.03e-51	82	100	82	0	-2	2	-2/2
ENSG00000124784	ENSG00000164304	1.94e-51	82	100	82	0	2	-2	2/-2
ENSG00000124784	ENSG00000164304	1.79e-50	82	100	82	0	3	-3	3/-3
ENSG00000124784	ENSG00000164304	3.38e-50	82	100	82	0	-3	3	-3/3
ENSG00000124784	ENSG00000164304	4.65e-50	82	100	82	0	-1	1	-1/1
ENSG00000124784	ENSG00000164304	4.29e-49	82	100	82	0	1	-1	1/-1
ENSG00000101350	ENSG00000084731	0	114	83.333	95	19	3	1	3/1
ENSG00000101350	ENSG00000084731	0	114	83.333	95	19	3	2	3/2
ENSG00000154529	ENSG00000106714	0	1216	98.273	1195	21	1	3	1/3
ENSG00000204248	ENSG00000130635	0	107	86.916	93	14	2	3	2/3
ENSG00000158639	ENSG00000238269	1.47e-78	135	87.407	118	17	-1	-3	-1/-3
ENSG00000206503	ENSG00000234745	0	312	86.859	271	41	1	3	1/3
ENSG00000159339	ENSG00000142619	1.56e-139	87	82.759	72	15	-2	-1	-2/-1
ENSG00000205364	ENSG00000169715	1.05e-66	62	87.097	54	8	1	2	1/2
ENSG00000096433	ENSG00000123104	0	146	84.932	124	22	2	1	2/1
ENSG00000206260	ENSG00000184814	2.94e-119	125	88.8	111	14	-1	-3	-1/-3
ENSG00000206260	ENSG00000233701	3.1900000000000002e-103	125	81.6	102	23	-1	-3	-1/-3
ENSG00000204612	ENSG00000171956	1.15e-83	116	90.517	105	11	1	3	1/3
ENSG00000119636	ENSG00000119711	1.88e-74	65	93.846	61	4	2	-1	2/-1
ENSG00000119636	ENSG00000119711	8.88e-43	65	93.846	61	4	2	-2	2/-2
