query	subject	evalue	alnlength	identity	identical	mismatches	qframe	sframe
CCDS27.1|Hs108|chr1	CCDS28.2|Hs108|chr1	7.55e-25	56	80.357	45	11	2	3
CCDS33.1|Hs108|chr1	CCDS44041.1|Hs108|chr1	1.88e-123	53	92.453	49	4	-2	-3
CCDS38.2|Hs108|chr1	CCDS57965.1|Hs108|chr1	2.3e-68	106	90.566	96	10	-3	-1
CCDS131.1|Hs108|chr1	CCDS132.1|Hs108|chr1	2.97e-120	94	100	94	0	-3	-1
CCDS132.1|Hs108|chr1	CCDS81261.1|Hs108|chr1	3.1e-164	125	100	125	0	1	2
CCDS132.1|Hs108|chr1	CCDS81261.1|Hs108|chr1	2.96e-142	125	100	125	0	-1	-3
CCDS132.1|Hs108|chr1	CCDS81261.1|Hs108|chr1	1.16e-109	125	100	125	0	-2	-1
CCDS132.1|Hs108|chr1	CCDS131.1|Hs108|chr1	3.49e-120	94	100	94	0	-1	-3
CCDS136.1|Hs108|chr1	CCDS44056.1|Hs108|chr1	1.45e-72	96	98.958	95	1	1	2
CCDS471.1|Hs108|chr1	CCDS53306.1|Hs108|chr1	1.72e-93	66	83.333	55	11	-3	-1
CCDS574.1|Hs108|chr1	CCDS72796.1|Hs108|chr1	0	51	100	51	0	-1	-3
CCDS716.1|Hs108|chr1	CCDS55510.1|Hs108|chrX	5.42e-83	102	96.078	98	4	2	1
CCDS797.1|Hs108|chr1	CCDS30791.1|Hs108|chr1	0	80	100	80	0	-1	-3
CCDS856.1|Hs108|chr1	CCDS30806.1|Hs108|chr1	5.05e-79	51	92.157	47	4	1	3
CCDS1055.1|Hs108|chr1	CCDS72920.1|Hs108|chr1	2.35e-48	59	93.22	55	4	-1	-3
CCDS1085.1|Hs108|chr1	CCDS58032.1|Hs108|chr1	0	62	100	62	0	2	1
CCDS1085.1|Hs108|chr1	CCDS58032.1|Hs108|chr1	0	62	100	62	0	-3	-1
CCDS1086.1|Hs108|chr1	CCDS58032.1|Hs108|chr1	0	53	83.019	44	9	2	1
CCDS1087.1|Hs108|chr1	CCDS58032.1|Hs108|chr1	5.07e-23	53	83.019	44	9	2	1
CCDS1093.1|Hs108|chr1	CCDS44239.1|Hs108|chr1	8.64e-21	52	80.769	42	10	-3	-2
CCDS1134.1|Hs108|chr1	CCDS55650.1|Hs108|chr1	3.88e-33	57	98.246	56	1	1	2
CCDS1134.1|Hs108|chr1	CCDS55651.1|Hs108|chr1	1.01e-32	56	98.214	55	1	-1	-3
CCDS1135.1|Hs108|chr1	CCDS72946.1|Hs108|chr1	0	71	98.592	70	1	1	3
CCDS1135.1|Hs108|chr1	CCDS1136.1|Hs108|chr1	1.24e-102	95	97.895	93	2	-2	-1
CCDS1136.1|Hs108|chr1	CCDS1135.1|Hs108|chr1	7.08e-99	98	95.918	94	4	-1	-2
CCDS1154.1|Hs108|chr1	CCDS44246.1|Hs108|chr1	6.93e-176	67	98.507	66	1	3	1
CCDS1207.1|Hs108|chr1	CCDS81389.1|Hs108|chr1	0	72	94.444	68	4	1	3
CCDS1708.1|Hs108|chr2	CCDS56112.1|Hs108|chr2	1.48e-137	57	82.456	47	10	-3	-2
CCDS1744.1|Hs108|chr2	CCDS77397.1|Hs108|chr2	1.74e-48	65	100	65	0	3	2
CCDS2117.1|Hs108|chr2	CCDS34975.1|Hs108|chr9	2.67e-124	134	88.806	119	15	2	1
CCDS2117.1|Hs108|chr2	CCDS43833.1|Hs108|chr9	1.42e-87	85	80	68	17	-1	-2
CCDS2162.1|Hs108|chr2	CCDS74574.1|Hs108|chr2	8.6e-108	63	100	63	0	-2	-3
CCDS2244.1|Hs108|chr2	CCDS46449.1|Hs108|chr2	1.66e-52	95	98.947	94	1	-3	-2
CCDS2589.1|Hs108|chr3	CCDS54552.1|Hs108|chr3	0	77	100	77	0	2	3
CCDS2689.1|Hs108|chr3	CCDS68391.1|Hs108|chr3	0	67	100	67	0	1	3
CCDS2689.1|Hs108|chr3	CCDS68391.1|Hs108|chr3	1.95e-19	67	100	67	0	3	2
CCDS2763.1|Hs108|chr3	CCDS77733.1|Hs108|chr3	8.77e-110	101	99.01	100	1	-3	-1
CCDS2783.1|Hs108|chr3	CCDS63632.1|Hs108|chr3	0	76	98.684	75	1	-2	-1
CCDS2852.1|Hs108|chr3	CCDS46841.1|Hs108|chr3	6.22e-117	60	98.333	59	1	1	2
CCDS2950.1|Hs108|chr3	CCDS63712.1|Hs108|chr3	0	179	100	179	0	-1	-2
CCDS3042.1|Hs108|chr3	CCDS46899.1|Hs108|chr3	0	91	100	91	0	-1	-3
CCDS3042.1|Hs108|chr3	CCDS46899.1|Hs108|chr3	1.09e-169	91	100	91	0	1	2
CCDS3069.1|Hs108|chr3	CCDS54639.1|Hs108|chr3	0	60	100	60	0	-3	-1
CCDS3139.1|Hs108|chr3	CCDS54655.1|Hs108|chr3	2.21e-176	59	98.305	58	1	-3	-1
CCDS3139.1|Hs108|chr3	CCDS54655.1|Hs108|chr3	1.46e-171	59	98.305	58	1	3	2
CCDS3265.1|Hs108|chr3	CCDS77867.1|Hs108|chr3	0	128	100	128	0	-1	-3
CCDS3308.2|Hs108|chr3	CCDS54698.1|Hs108|chr3	0	53	100	53	0	-1	-2
CCDS3308.2|Hs108|chr3	CCDS54698.1|Hs108|chr3	0	53	100	53	0	1	3
CCDS3370.2|Hs108|chr4	CCDS54717.1|Hs108|chr4	2e-135	85	90.588	77	8	1	2
CCDS3517.1|Hs108|chr4	CCDS47064.1|Hs108|chr4	9.68e-121	77	100	77	0	-2	-1
CCDS3569.1|Hs108|chr4	CCDS56334.1|Hs108|chr4	2.45e-77	111	99.099	110	1	-1	-2
CCDS3569.1|Hs108|chr4	CCDS56334.1|Hs108|chr4	1.53e-65	111	99.099	110	1	-2	-3
CCDS3628.1|Hs108|chr4	CCDS58910.1|Hs108|chr4	0	66	96.97	64	2	2	1
CCDS3628.1|Hs108|chr4	CCDS58910.1|Hs108|chr4	0	66	96.97	64	2	-3	-1
CCDS3662.1|Hs108|chr4	CCDS75173.1|Hs108|chr4	0	57	100	57	0	3	1
CCDS3662.1|Hs108|chr4	CCDS75173.1|Hs108|chr4	0	57	100	57	0	-3	-2
CCDS3901.1|Hs108|chr5	CCDS75232.1|Hs108|chr5	4.08e-148	59	96.61	57	2	1	2
CCDS3902.1|Hs108|chr5	CCDS3903.1|Hs108|chr5	7.44e-129	69	100	69	0	3	1
CCDS3902.1|Hs108|chr5	CCDS3903.1|Hs108|chr5	7.03e-61	69	100	69	0	-3	-2
CCDS3903.1|Hs108|chr5	CCDS3902.1|Hs108|chr5	3.14e-129	69	100	69	0	1	3
CCDS3903.1|Hs108|chr5	CCDS3902.1|Hs108|chr5	2.97e-61	69	100	69	0	-2	-3
CCDS3903.1|Hs108|chr5	CCDS54836.1|Hs108|chr5	3.24e-129	69	100	69	0	1	3
CCDS3903.1|Hs108|chr5	CCDS54836.1|Hs108|chr5	3.07e-61	69	100	69	0	-2	-3
CCDS4226.1|Hs108|chr5	CCDS4224.1|Hs108|chr5	7.46e-25	58	100	58	0	1	2
CCDS4567.1|Hs108|chr6	CCDS69060.1|Hs108|chr6	0	76	100	76	0	-2	-1
CCDS4715.1|Hs108|chr6	CCDS34406.1|Hs108|chr6	1.71e-143	51	100	51	0	-3	-2
CCDS4715.1|Hs108|chr6	CCDS34406.1|Hs108|chr6	4.48e-137	51	100	51	0	2	3
CCDS4715.1|Hs108|chr6	CCDS34406.1|Hs108|chr6	2.43e-125	51	100	51	0	-1	-3
CCDS4716.1|Hs108|chr6	CCDS34406.1|Hs108|chr6	9.52e-135	75	96	72	3	1	2
CCDS4717.1|Hs108|chr6	CCDS4716.1|Hs108|chr6	3.22e-90	65	92.308	60	5	-2	-3
CCDS4717.1|Hs108|chr6	CCDS4715.1|Hs108|chr6	5.35e-119	64	85.938	55	9	2	1
CCDS4746.1|Hs108|chr6	CCDS4747.1|Hs108|chr6	0	73	100	73	0	2	3
CCDS4747.1|Hs108|chr6	CCDS4746.1|Hs108|chr6	0	73	100	73	0	3	2
CCDS4777.1|Hs108|chr6	CCDS4778.1|Hs108|chr6	0	60	100	60	0	-1	-3
CCDS4815.1|Hs108|chr6	CCDS4817.1|Hs108|chr6	1.27e-160	55	96.364	53	2	1	3
CCDS4816.1|Hs108|chr6	CCDS4817.1|Hs108|chr6	2.98e-170	55	96.364	53	2	1	3
CCDS4817.1|Hs108|chr6	CCDS4816.1|Hs108|chr6	2.49e-170	55	96.364	53	2	3	1
CCDS4817.1|Hs108|chr6	CCDS4815.1|Hs108|chr6	2.69e-160	55	96.364	53	2	3	1
CCDS4905.1|Hs108|chr6	CCDS55005.1|Hs108|chr6	3.67e-135	56	98.214	55	1	1	2
CCDS4905.1|Hs108|chr6	CCDS55005.1|Hs108|chr6	9.42e-133	56	98.214	55	1	-2	-1
CCDS4940.2|Hs108|chr6	CCDS75468.1|Hs108|chr6	0	74	95.946	71	3	1	3
CCDS4951.1|Hs108|chr6	CCDS75470.1|Hs108|chr6	1.42e-175	93	100	93	0	1	2
CCDS4951.1|Hs108|chr6	CCDS75470.1|Hs108|chr6	1.29e-171	93	100	93	0	-1	-3
CCDS5055.1|Hs108|chr6	CCDS75498.1|Hs108|chr6	7.27e-55	56	100	56	0	2	1
CCDS5055.1|Hs108|chr6	CCDS75498.1|Hs108|chr6	2.57e-54	56	100	56	0	-1	-2
CCDS5274.1|Hs108|chr6	CCDS5275.1|Hs108|chr6	0	54	92.593	50	4	3	1
CCDS5275.1|Hs108|chr6	CCDS5274.1|Hs108|chr6	0	54	92.593	50	4	1	3
CCDS5473.1|Hs108|chr7	CCDS64632.1|Hs108|chr7	5.62e-28	53	100	53	0	-2	-1
CCDS5529.1|Hs108|chr7	CCDS64663.1|Hs108|chr7	8.83e-83	76	100	76	0	-2	-1
CCDS5529.1|Hs108|chr7	CCDS64663.1|Hs108|chr7	1.17e-81	76	100	76	0	1	2
CCDS5714.1|Hs108|chr7	CCDS75643.1|Hs108|chr7	4.69e-178	52	100	52	0	1	2
CCDS5714.1|Hs108|chr7	CCDS75643.1|Hs108|chr7	1.66e-145	52	100	52	0	-2	-1
CCDS5765.1|Hs108|chr7	CCDS5766.1|Hs108|chr7	3.43e-33	58	89.655	52	6	3	2
CCDS5766.1|Hs108|chr7	CCDS5765.1|Hs108|chr7	6.55e-33	58	89.655	52	6	2	3
CCDS5804.1|Hs108|chr7	CCDS64763.1|Hs108|chr7	4.11e-159	63	98.413	62	1	-3	-2
CCDS5819.1|Hs108|chr7	CCDS47713.1|Hs108|chr7	0	58	100	58	0	-1	-2
CCDS5858.1|Hs108|chr7	CCDS75669.1|Hs108|chr7	0	54	100	54	0	-3	-1
CCDS5858.1|Hs108|chr7	CCDS5859.1|Hs108|chr7	0	54	100	54	0	-3	-1
CCDS5859.1|Hs108|chr7	CCDS5858.1|Hs108|chr7	0	54	100	54	0	-1	-3
CCDS5925.2|Hs108|chr7	CCDS64806.1|Hs108|chr7	0	141	97.163	137	4	-1	-3
CCDS6181.1|Hs108|chr8	CCDS69490.1|Hs108|chr8	3.5e-115	54	98.148	53	1	3	1
CCDS6511.2|Hs108|chr9	CCDS56565.1|Hs108|chr9	4.36e-41	69	100	69	0	2	1
CCDS6511.2|Hs108|chr9	CCDS6512.1|Hs108|chr9	4.36e-41	69	100	69	0	2	1
CCDS6705.1|Hs108|chr9	CCDS75859.1|Hs108|chr9	1.2e-53	83	98.795	82	1	-2	1
CCDS6705.1|Hs108|chr9	CCDS6706.1|Hs108|chr9	1.19e-53	83	98.795	82	1	-2	1
CCDS6882.1|Hs108|chr9	CCDS69669.1|Hs108|chr9	0	68	94.118	64	4	1	3
CCDS6914.1|Hs108|chr9	CCDS43885.1|Hs108|chr9	0	140	100	140	0	3	1
CCDS6914.1|Hs108|chr9	CCDS43885.1|Hs108|chr9	0	140	100	140	0	-3	-2
CCDS6914.1|Hs108|chr9	CCDS43885.1|Hs108|chr9	0	140	100	140	0	-1	-3
CCDS6914.1|Hs108|chr9	CCDS43885.1|Hs108|chr9	3.15e-177	140	100	140	0	-2	-1
CCDS6914.1|Hs108|chr9	CCDS43886.1|Hs108|chr9	3.15e-177	140	100	140	0	3	1
CCDS6914.1|Hs108|chr9	CCDS43886.1|Hs108|chr9	1.19e-173	140	100	140	0	-3	-2
CCDS6914.1|Hs108|chr9	CCDS43886.1|Hs108|chr9	5.22e-168	140	100	140	0	-1	-3
CCDS6914.1|Hs108|chr9	CCDS43886.1|Hs108|chr9	2.88e-161	140	100	140	0	-2	-1
CCDS6924.1|Hs108|chr9	CCDS6925.1|Hs108|chr9	5.19e-130	64	100	64	0	2	1
CCDS6924.1|Hs108|chr9	CCDS6925.1|Hs108|chr9	7.12e-130	64	100	64	0	-1	-2
CCDS6924.1|Hs108|chr9	CCDS6925.1|Hs108|chr9	1.19e-124	64	100	64	0	1	3
CCDS6924.1|Hs108|chr9	CCDS6925.1|Hs108|chr9	7.32e-123	64	100	64	0	-2	-3
CCDS6925.1|Hs108|chr9	CCDS6924.1|Hs108|chr9	1.13e-130	64	100	64	0	-2	-1
CCDS6925.1|Hs108|chr9	CCDS6924.1|Hs108|chr9	2.14e-130	64	100	64	0	1	2
CCDS6960.1|Hs108|chr9	CCDS65176.1|Hs108|chr9	0	176	99.432	175	1	1	3
CCDS6969.1|Hs108|chr9	CCDS65179.1|Hs108|chr9	3.55e-150	62	93.548	58	4	-3	-1
CCDS7059.1|Hs108|chr10	CCDS55698.1|Hs108|chr10	0	53	96.226	51	2	2	3
CCDS7109.1|Hs108|chr10	CCDS76284.1|Hs108|chr10	3.56e-22	65	87.692	57	8	-3	-1
CCDS7582.1|Hs108|chr10	CCDS7580.1|Hs108|chr10	5.09e-155	82	100	82	0	3	1
CCDS7582.1|Hs108|chr10	CCDS7580.1|Hs108|chr10	8.77e-154	82	100	82	0	-1	-3
CCDS7582.1|Hs108|chr10	CCDS7580.1|Hs108|chr10	7.49e-141	82	100	82	0	1	2
CCDS7582.1|Hs108|chr10	CCDS7580.1|Hs108|chr10	2.04e-137	82	100	82	0	-2	-1
CCDS7582.1|Hs108|chr10	CCDS7581.1|Hs108|chr10	5.1e-155	82	100	82	0	3	1
CCDS7582.1|Hs108|chr10	CCDS7581.1|Hs108|chr10	8.77e-154	82	100	82	0	-1	-3
CCDS7582.1|Hs108|chr10	CCDS7581.1|Hs108|chr10	7.49e-141	82	100	82	0	1	2
CCDS7582.1|Hs108|chr10	CCDS7581.1|Hs108|chr10	2.05e-137	82	100	82	0	-2	-1
CCDS7629.1|Hs108|chr10	CCDS81517.1|Hs108|chr10	0	78	91.026	71	7	3	2
CCDS7747.1|Hs108|chr11	CCDS73245.1|Hs108|chr11	2.1e-145	52	88.462	46	6	-2	-3
CCDS7900.1|Hs108|chr11	CCDS76395.1|Hs108|chr11	4.49e-106	82	97.561	80	2	1	2
CCDS7969.1|Hs108|chr11	CCDS76407.1|Hs108|chr11	0	55	96.364	53	2	2	1
CCDS8023.2|Hs108|chr11	CCDS76415.1|Hs108|chr11	0	63	100	63	0	3	1
CCDS8028.1|Hs108|chr11	CCDS73306.1|Hs108|chr11	2.09e-54	85	100	85	0	1	3
CCDS8031.1|Hs108|chr11	CCDS55769.1|Hs108|chr11	5.44e-172	72	93.056	67	5	1	3
CCDS8080.1|Hs108|chr11	CCDS44642.2|Hs108|chr11	0	80	100	80	0	2	3
CCDS8081.1|Hs108|chr11	CCDS44642.2|Hs108|chr11	0	83	100	83	0	2	3
CCDS8137.1|Hs108|chr11	CCDS73326.1|Hs108|chr11	2.82e-149	87	100	87	0	-1	-3
CCDS8162.1|Hs108|chr11	CCDS58150.1|Hs108|chr11	0	103	94.175	97	6	1	2
CCDS8215.1|Hs108|chr11	CCDS58152.1|Hs108|chr11	0	71	100	71	0	3	1
CCDS8230.1|Hs108|chr11	CCDS73347.1|Hs108|chr11	0	55	96.364	53	2	2	1
CCDS8234.1|Hs108|chr11	CCDS60893.1|Hs108|chr11	0	57	100	57	0	-3	-1
CCDS8573.1|Hs108|chr12	CCDS73431.1|Hs108|chr12	0	95	100	95	0	-3	-1
CCDS8573.1|Hs108|chr12	CCDS73431.1|Hs108|chr12	0	95	100	95	0	-1	-2
CCDS8573.1|Hs108|chr12	CCDS73431.1|Hs108|chr12	2.61e-177	95	100	95	0	2	1
CCDS8618.1|Hs108|chr12	CCDS53745.1|Hs108|chr12	6.71e-63	52	86.538	45	7	-3	-2
CCDS8659.2|Hs108|chr12	CCDS44835.1|Hs108|chr12	3.57e-179	121	99.174	120	1	3	2
CCDS8683.1|Hs108|chr12	CCDS53757.1|Hs108|chr12	2.19e-31	63	95.238	60	3	-2	-1
CCDS8683.1|Hs108|chr12	CCDS53759.1|Hs108|chr12	2.19e-31	63	95.238	60	3	-2	-1
CCDS8721.1|Hs108|chr12	CCDS44856.1|Hs108|chr12	2.46e-96	90	96.667	87	3	-2	-1
CCDS8858.1|Hs108|chr12	CCDS55829.1|Hs108|chr12	0	50	100	50	0	2	1
CCDS8858.1|Hs108|chr12	CCDS55829.1|Hs108|chr12	0	50	100	50	0	-1	-2
CCDS8858.1|Hs108|chr12	CCDS55829.1|Hs108|chr12	0	50	100	50	0	-3	-1
CCDS8895.1|Hs108|chr12	CCDS61146.1|Hs108|chr12	6.44e-174	58	94.828	55	3	-2	-1
CCDS8955.3|Hs108|chr12	CCDS8956.1|Hs108|chr12	2.14e-101	65	100	65	0	-1	-3
CCDS8955.3|Hs108|chr12	CCDS8956.1|Hs108|chr12	1.32e-99	65	100	65	0	3	1
CCDS8955.3|Hs108|chr12	CCDS8956.1|Hs108|chr12	1e-96	65	100	65	0	-3	-2
CCDS8955.3|Hs108|chr12	CCDS8956.1|Hs108|chr12	7.66e-32	65	100	65	0	2	3
CCDS8956.1|Hs108|chr12	CCDS8955.3|Hs108|chr12	9.13e-102	65	100	65	0	-3	-1
CCDS8956.1|Hs108|chr12	CCDS8955.3|Hs108|chr12	5.68e-100	65	100	65	0	1	3
CCDS8956.1|Hs108|chr12	CCDS8955.3|Hs108|chr12	4.28e-97	65	100	65	0	-2	-3
CCDS8956.1|Hs108|chr12	CCDS8955.3|Hs108|chr12	3.86e-85	65	100	65	0	3	2
CCDS8956.1|Hs108|chr12	CCDS8955.3|Hs108|chr12	3.66e-69	65	100	65	0	-1	-2
CCDS9206.1|Hs108|chr12	CCDS76609.1|Hs108|chr12	3.99e-39	90	86.667	78	12	1	3
CCDS9604.1|Hs108|chr14	CCDS41927.1|Hs108|chr14	0	56	100	56	0	1	3
CCDS9604.1|Hs108|chr14	CCDS41927.1|Hs108|chr14	0	56	100	56	0	-1	-2
CCDS9604.1|Hs108|chr14	CCDS41927.1|Hs108|chr14	1.56e-177	56	100	56	0	-2	-3
CCDS9604.1|Hs108|chr14	CCDS41927.1|Hs108|chr14	5.8e-170	56	100	56	0	3	2
CCDS9686.1|Hs108|chr14	CCDS9687.1|Hs108|chr14	1.06e-87	55	96.364	53	2	-1	-3
CCDS9687.1|Hs108|chr14	CCDS9686.1|Hs108|chr14	2.57e-88	55	96.364	53	2	-3	-1
CCDS9768.1|Hs108|chr14	CCDS76691.1|Hs108|chr14	2.08e-107	61	95.082	58	3	-3	-2
CCDS9768.1|Hs108|chr14	CCDS81812.1|Hs108|chr14	1e-74	61	95.082	58	3	-3	-2
CCDS9864.1|Hs108|chr14	CCDS45143.1|Hs108|chr14	5.67e-163	84	100	84	0	1	3
CCDS9864.1|Hs108|chr14	CCDS45143.1|Hs108|chr14	3.12e-118	84	100	84	0	-1	-2
CCDS9867.1|Hs108|chr14	CCDS81830.1|Hs108|chr14	0	67	100	67	0	-1	-2
CCDS10066.1|Hs108|chr15	CCDS45230.1|Hs108|chr15	5.58e-93	63	96.825	61	2	3	2
CCDS10381.1|Hs108|chr15	CCDS66877.1|Hs108|chr15	0	64	100	64	0	1	2
CCDS10411.1|Hs108|chr16	CCDS10412.1|Hs108|chr16	0	52	100	52	0	1	3
CCDS10412.1|Hs108|chr16	CCDS10411.1|Hs108|chr16	0	52	98.077	51	1	1	2
CCDS10447.2|Hs108|chr16	CCDS66900.1|Hs108|chr16	5.36e-50	98	96.939	95	3	-1	-2
CCDS10483.1|Hs108|chr16	CCDS10484.1|Hs108|chr16	0	55	100	55	0	2	1
CCDS10484.1|Hs108|chr16	CCDS10483.1|Hs108|chr16	0	54	100	54	0	-3	-2
CCDS10484.1|Hs108|chr16	CCDS10483.1|Hs108|chr16	2.57e-159	54	100	54	0	3	1
CCDS10493.2|Hs108|chr16	CCDS61814.1|Hs108|chr16	0	84	100	84	0	1	2
CCDS10493.2|Hs108|chr16	CCDS61814.1|Hs108|chr16	0	84	100	84	0	-1	-3
CCDS10540.1|Hs108|chr16	CCDS58422.1|Hs108|chr16	0	52	96.154	50	2	2	1
CCDS10560.1|Hs108|chr16	CCDS45421.1|Hs108|chr16	5.07e-34	56	82.143	46	10	-2	-3
CCDS10664.1|Hs108|chr16	CCDS58449.1|Hs108|chr16	2.43e-103	74	89.189	66	8	3	1
CCDS10781.2|Hs108|chr16	CCDS76877.1|Hs108|chr16	2.67e-173	58	98.276	57	1	3	1
CCDS10905.1|Hs108|chr16	CCDS59272.1|Hs108|chr16	0	77	100	77	0	-2	-1
CCDS10905.1|Hs108|chr16	CCDS59272.1|Hs108|chr16	0	77	100	77	0	-1	-3
CCDS10905.1|Hs108|chr16	CCDS59272.1|Hs108|chr16	0	77	100	77	0	1	2
CCDS10905.1|Hs108|chr16	CCDS59271.1|Hs108|chr16	0	77	100	77	0	-2	-1
CCDS10905.1|Hs108|chr16	CCDS59271.1|Hs108|chr16	0	77	100	77	0	-1	-3
CCDS10905.1|Hs108|chr16	CCDS59271.1|Hs108|chr16	0	77	100	77	0	1	2
CCDS11007.1|Hs108|chr17	CCDS45564.1|Hs108|chr17	0	84	92.857	78	6	-2	-3
CCDS11178.2|Hs108|chr17	CCDS45620.1|Hs108|chr17	4.28e-95	89	98.876	88	1	-1	-2
CCDS11193.1|Hs108|chr17	CCDS45625.1|Hs108|chr17	7.04e-134	103	100	103	0	2	3
CCDS11193.1|Hs108|chr17	CCDS45625.1|Hs108|chr17	8.65e-116	103	100	103	0	-1	-3
CCDS11193.1|Hs108|chr17	CCDS45625.1|Hs108|chr17	1.33e-101	103	100	103	0	1	2
CCDS11202.1|Hs108|chr17	CCDS82085.1|Hs108|chr17	8.83e-106	63	98.413	62	1	1	3
CCDS11241.1|Hs108|chr17	CCDS43437.1|Hs108|chr6	2.93e-21	63	82.54	52	11	3	-1
CCDS11262.1|Hs108|chr17	CCDS11263.1|Hs108|chr17	2.05e-21	52	82.692	43	9	-1	-2
CCDS11263.1|Hs108|chr17	CCDS11262.1|Hs108|chr17	8.82e-22	52	82.692	43	9	-2	-1
CCDS11341.1|Hs108|chr17	CCDS54117.1|Hs108|chr17	1.8e-23	73	80.822	59	14	2	1
CCDS11446.1|Hs108|chr17	CCDS59291.1|Hs108|chr17	2.5e-120	64	100	64	0	1	2
CCDS11446.1|Hs108|chr17	CCDS59291.1|Hs108|chr17	2.79e-114	64	100	64	0	-1	-3
CCDS11647.1|Hs108|chr17	CCDS45757.1|Hs108|chr17	1.88e-129	66	100	66	0	1	3
CCDS11647.1|Hs108|chr17	CCDS45757.1|Hs108|chr17	1.25e-128	66	100	66	0	-1	-2
CCDS11737.1|Hs108|chr17	CCDS45626.1|Hs108|chr17	1.88e-163	91	85.714	78	13	3	1
CCDS11786.1|Hs108|chr17	CCDS74176.1|Hs108|chr17	3.24e-174	84	100	84	0	-1	-3
CCDS11786.1|Hs108|chr17	CCDS74176.1|Hs108|chr17	1.85e-160	84	100	84	0	1	2
CCDS11786.1|Hs108|chr17	CCDS74176.1|Hs108|chr17	3.95e-147	84	100	84	0	-2	-1
CCDS11789.1|Hs108|chr17	CCDS32769.1|Hs108|chr17	3.95e-58	55	90.909	50	5	-2	-1
CCDS11789.1|Hs108|chr17	CCDS74180.1|Hs108|chr17	2.57e-25	56	92.857	52	4	2	3
CCDS11874.1|Hs108|chr18	CCDS11875.1|Hs108|chr18	1.54e-40	99	81.818	81	18	2	3
CCDS11875.1|Hs108|chr18	CCDS11874.1|Hs108|chr18	1.6e-40	99	81.818	81	18	3	2
CCDS12021.1|Hs108|chr18	CCDS54194.1|Hs108|chr18	1.95e-163	81	98.765	80	1	2	1
CCDS12037.1|Hs108|chr19	CCDS74241.1|Hs108|chr19	1.16e-82	58	100	58	0	1	2
CCDS12172.1|Hs108|chr19	CCDS74272.1|Hs108|chr19	0	55	90.909	50	5	2	1
CCDS12206.1|Hs108|chr19	CCDS62529.1|Hs108|chr19	0	105	100	105	0	1	3
CCDS12206.1|Hs108|chr19	CCDS62529.1|Hs108|chr19	0	105	100	105	0	-2	-3
CCDS12206.1|Hs108|chr19	CCDS62529.1|Hs108|chr19	0	105	100	105	0	3	2
CCDS12226.1|Hs108|chr19	CCDS56082.1|Hs108|chr19	3.04e-48	73	100	73	0	3	2
CCDS12232.1|Hs108|chr19	CCDS32904.1|Hs108|chr19	3.08e-163	117	99.145	116	1	-1	-3
CCDS12365.1|Hs108|chr19	CCDS58655.1|Hs108|chr19	1.38e-84	63	100	63	0	2	1
CCDS12365.1|Hs108|chr19	CCDS58655.1|Hs108|chr19	7.4e-75	63	100	63	0	-1	-2
CCDS12365.1|Hs108|chr19	CCDS58655.1|Hs108|chr19	6.02e-50	63	100	63	0	-3	-1
CCDS12473.1|Hs108|chr19	CCDS42551.1|Hs108|chr19	1.31e-67	61	100	61	0	-2	-1
CCDS12533.1|Hs108|chr19	CCDS59387.1|Hs108|chr19	0	76	100	76	0	-3	-1
CCDS12655.1|Hs108|chr19	CCDS59395.1|Hs108|chr19	8.08e-44	87	98.851	86	1	3	1
CCDS12681.2|Hs108|chr19	CCDS42580.2|Hs108|chr19	0	51	100	51	0	-1	-2
CCDS12681.2|Hs108|chr19	CCDS42580.2|Hs108|chr19	0	51	100	51	0	1	3
CCDS12682.1|Hs108|chr19	CCDS42580.2|Hs108|chr19	0	51	100	51	0	-1	-2
CCDS12682.1|Hs108|chr19	CCDS42580.2|Hs108|chr19	0	51	100	51	0	1	3
CCDS12694.1|Hs108|chr19	CCDS82371.1|Hs108|chr19	6.93e-124	55	100	55	0	-2	-1
CCDS12697.1|Hs108|chr19	CCDS46129.1|Hs108|chr19	4.7e-82	98	100	98	0	1	2
CCDS12775.1|Hs108|chr19	CCDS59409.1|Hs108|chr19	0	101	100	101	0	-2	-1
CCDS12775.1|Hs108|chr19	CCDS59409.1|Hs108|chr19	0	101	100	101	0	1	2
CCDS12998.1|Hs108|chr20	CCDS82588.1|Hs108|chr20	2.07e-176	103	100	103	0	-1	-2
CCDS13000.2|Hs108|chr20	CCDS82588.1|Hs108|chr20	2.75e-176	103	100	103	0	-1	-2
CCDS13131.1|Hs108|chr20	CCDS82600.1|Hs108|chr20	8.71e-150	60	96.667	58	2	1	2
CCDS13336.1|Hs108|chr20	CCDS82619.1|Hs108|chr20	9.47e-106	82	93.902	77	5	3	2
CCDS13336.1|Hs108|chr20	CCDS82619.1|Hs108|chr20	8.05e-79	82	93.902	77	5	-3	-1
CCDS13400.1|Hs108|chr20	CCDS54470.1|Hs108|chr20	0	66	92.424	61	5	-1	-2
CCDS13515.1|Hs108|chr20	CCDS63326.1|Hs108|chr20	0	53	88.679	47	6	1	3
CCDS13516.1|Hs108|chr20	CCDS63326.1|Hs108|chr20	0	50	88	44	6	1	3
CCDS13536.1|Hs108|chr20	CCDS82638.1|Hs108|chr20	4.44e-111	114	100	114	0	2	3
CCDS13673.1|Hs108|chr21	CCDS74796.1|Hs108|chr21	0	91	86.813	79	12	3	1
CCDS13737.1|Hs108|chr21	CCDS68231.1|Hs108|chr21	1.35e-177	73	95.89	70	3	1	2
CCDS13737.1|Hs108|chr21	CCDS68231.1|Hs108|chr21	1.18e-172	73	95.89	70	3	-2	-1
CCDS13764.1|Hs108|chr22	CCDS56224.1|Hs108|chr22	0	67	100	67	0	3	1
CCDS13814.2|Hs108|chr22	CCDS82698.1|Hs108|chr22	2.72e-90	69	95.652	66	3	3	2
CCDS13872.1|Hs108|chr22	CCDS58799.1|Hs108|chr22	9.08e-51	82	100	82	0	1	2
CCDS13883.1|Hs108|chr22	CCDS77667.1|Hs108|chr22	8.8e-75	64	100	64	0	-2	-1
CCDS13921.1|Hs108|chr22	CCDS43013.1|Hs108|chr22	0	69	100	69	0	-2	-1
CCDS13921.1|Hs108|chr22	CCDS46701.1|Hs108|chr22	0	69	100	69	0	-2	-1
CCDS14356.1|Hs108|chrX	CCDS75987.1|Hs108|chrX	8.25e-46	90	97.778	88	2	2	1
CCDS14356.1|Hs108|chrX	CCDS75987.1|Hs108|chrX	1.44e-44	90	97.778	88	2	-1	-2
CCDS14432.1|Hs108|chrX	CCDS75995.1|Hs108|chrX	4.85e-83	71	100	71	0	1	3
CCDS14564.1|Hs108|chrX	CCDS59174.1|Hs108|chrX	1.45e-177	101	95.05	96	5	3	1
CCDS14661.1|Hs108|chrX	CCDS55510.1|Hs108|chrX	1.34e-84	102	100	102	0	2	1
CCDS14682.1|Hs108|chrX	CCDS55518.1|Hs108|chrX	0	80	100	80	0	-1	-2
CCDS14770.4|Hs108|chrX	CCDS55548.1|Hs108|chrY	1.71e-115	54	100	54	0	1	2
CCDS14770.4|Hs108|chrY	CCDS55548.1|Hs108|chrY	1.71e-115	54	100	54	0	1	2
CCDS14771.4|Hs108|chrX	CCDS59180.1|Hs108|chrY	4.6e-103	65	93.846	61	4	3	2
CCDS14771.4|Hs108|chrY	CCDS59180.1|Hs108|chrY	4.6e-103	65	93.846	61	4	3	2
CCDS30585.1|Hs108|chr1	CCDS44056.1|Hs108|chr1	6.29e-71	103	100	103	0	-2	-1
CCDS30586.1|Hs108|chr1	CCDS30585.1|Hs108|chr1	5.24e-64	109	96.33	105	4	-1	-2
CCDS30653.1|Hs108|chr1	CCDS65461.1|Hs108|chr1	1.5e-122	51	90.196	46	5	2	1
CCDS30653.1|Hs108|chr1	CCDS41290.1|Hs108|chr1	2.95e-122	51	90.196	46	5	2	1
CCDS30791.1|Hs108|chr1	CCDS797.1|Hs108|chr1	0	80	100	80	0	-3	-1
CCDS30886.1|Hs108|chr1	CCDS55649.1|Hs108|chr1	6.62e-106	58	100	58	0	2	1
CCDS30919.1|Hs108|chr1	CCDS41425.1|Hs108|chr1	0	55	100	55	0	-2	-1
CCDS30927.1|Hs108|chr1	CCDS72963.1|Hs108|chr1	0	131	98.473	129	2	-3	-1
CCDS30927.1|Hs108|chr1	CCDS72965.1|Hs108|chr1	0	131	98.473	129	2	-3	-1
CCDS31319.2|Hs108|chr10	CCDS58103.1|Hs108|chr10	0	107	90.654	97	10	-1	-3
CCDS31319.2|Hs108|chr10	CCDS58102.1|Hs108|chr10	0	79	100	79	0	1	2
CCDS31450.1|Hs108|chr11	CCDS73269.1|Hs108|chr11	9.19e-118	57	82.456	47	10	-1	-3
CCDS31458.1|Hs108|chr11	CCDS55755.1|Hs108|chr11	2.48e-95	71	94.366	67	4	-2	-3
CCDS31458.1|Hs108|chr11	CCDS55755.1|Hs108|chr11	3.34e-95	71	94.366	67	4	1	3
CCDS31458.1|Hs108|chr11	CCDS31457.1|Hs108|chr11	2.64e-95	71	94.366	67	4	-2	-3
CCDS31458.1|Hs108|chr11	CCDS31457.1|Hs108|chr11	3.55e-95	71	94.366	67	4	1	3
CCDS31599.1|Hs108|chr11	CCDS44642.2|Hs108|chr11	0	80	100	80	0	2	3
CCDS31603.1|Hs108|chr11	CCDS73316.1|Hs108|chr11	2.38e-55	76	80.263	61	15	3	1
CCDS31897.1|Hs108|chr12	CCDS55883.1|Hs108|chr12	1.21e-103	66	100	66	0	2	1
CCDS31897.1|Hs108|chr12	CCDS55883.1|Hs108|chr12	2.01e-24	66	100	66	0	-3	-1
CCDS31970.2|Hs108|chr13	CCDS66543.1|Hs108|chr13	5.68e-44	79	91.139	72	7	-1	-2
CCDS32166.1|Hs108|chr14	CCDS66722.1|Hs108|chr14	1.25e-98	54	100	54	0	-1	-3
CCDS32284.1|Hs108|chr15	CCDS55972.1|Hs108|chr15	0	54	96.296	52	2	-1	-2
CCDS32285.1|Hs108|chr15	CCDS55972.1|Hs108|chr15	0	54	96.296	52	2	-1	-2
CCDS32366.1|Hs108|chr16	CCDS66900.1|Hs108|chr16	4.4e-50	98	96.939	95	3	-1	-2
CCDS32769.1|Hs108|chr17	CCDS11789.1|Hs108|chr17	5.12e-32	51	98.039	50	1	-3	-1
CCDS32803.1|Hs108|chr18	CCDS74199.1|Hs108|chr18	0	56	98.214	55	1	-3	-1
CCDS32831.1|Hs108|chr18	CCDS62443.1|Hs108|chr18	1.83e-34	52	100	52	0	-1	-2
CCDS32831.1|Hs108|chr18	CCDS62443.1|Hs108|chr18	4.05e-32	52	100	52	0	2	1
CCDS32831.1|Hs108|chr18	CCDS62443.1|Hs108|chr18	1.44e-31	52	100	52	0	1	3
CCDS32831.1|Hs108|chr18	CCDS58622.1|Hs108|chr18	1.83e-34	52	100	52	0	-1	-2
CCDS32831.1|Hs108|chr18	CCDS58622.1|Hs108|chr18	4.05e-32	52	100	52	0	2	1
CCDS32831.1|Hs108|chr18	CCDS58622.1|Hs108|chr18	1.44e-31	52	100	52	0	1	3
CCDS32904.1|Hs108|chr19	CCDS12232.1|Hs108|chr19	1.1e-162	117	99.145	116	1	-3	-1
CCDS32904.1|Hs108|chr19	CCDS42500.1|Hs108|chr19	1.38e-135	82	93.902	77	5	-3	-1
CCDS33286.1|Hs108|chr2	CCDS74574.1|Hs108|chr2	1.07e-106	63	100	63	0	-2	-3
CCDS33418.1|Hs108|chr2	CCDS77551.1|Hs108|chr2	1.97e-42	71	100	71	0	1	-2
CCDS33519.1|Hs108|chr21	CCDS56205.1|Hs108|chr21	2.3e-169	63	100	63	0	-3	-1
CCDS33519.1|Hs108|chr21	CCDS56205.1|Hs108|chr21	2.46e-159	63	100	63	0	1	3
CCDS33519.1|Hs108|chr21	CCDS56205.1|Hs108|chr21	1.94e-156	63	100	63	0	3	2
CCDS33519.1|Hs108|chr21	CCDS56205.1|Hs108|chr21	7.88e-150	63	100	63	0	-1	-2
CCDS33754.1|Hs108|chr3	CCDS63632.1|Hs108|chr3	0	76	98.684	75	1	-2	-1
CCDS33921.1|Hs108|chr3	CCDS54698.1|Hs108|chr3	0	60	98.333	59	1	2	1
CCDS34127.2|Hs108|chr5	CCDS34128.2|Hs108|chr5	0	55	98.182	54	1	2	1
CCDS34128.2|Hs108|chr5	CCDS34127.2|Hs108|chr5	0	55	98.182	54	1	1	2
CCDS34406.1|Hs108|chr6	CCDS4715.1|Hs108|chr6	2.39e-125	54	96.296	52	2	2	1
CCDS34406.1|Hs108|chr6	CCDS4716.1|Hs108|chr6	1.07e-134	75	96	72	3	2	1
CCDS34459.1|Hs108|chr6	CCDS55016.1|Hs108|chr6	1.19e-53	65	100	65	0	-2	-1
CCDS34589.1|Hs108|chr7	CCDS64582.1|Hs108|chr7	0	97	100	97	0	1	2
CCDS34975.1|Hs108|chr9	CCDS2117.1|Hs108|chr2	2.41e-103	134	88.806	119	15	1	2
CCDS35180.1|Hs108|chr9	CCDS65192.1|Hs108|chr9	0	53	88.679	47	6	-3	-1
CCDS35247.1|Hs108|chrX	CCDS75973.1|Hs108|chrX	8.34e-80	56	98.214	55	1	2	1
CCDS41248.1|Hs108|chr1	CCDS136.1|Hs108|chr1	8.56e-68	95	100	95	0	1	3
CCDS41248.1|Hs108|chr1	CCDS136.1|Hs108|chr1	9.76e-66	95	100	95	0	-1	-2
CCDS41284.1|Hs108|chr1	CCDS44089.1|Hs108|chr1	9.09e-145	56	100	56	0	-3	-1
CCDS41284.1|Hs108|chr1	CCDS44089.1|Hs108|chr1	2.29e-129	56	100	56	0	2	1
CCDS41284.1|Hs108|chr1	CCDS44089.1|Hs108|chr1	8.98e-125	56	100	56	0	-1	-2
CCDS41290.1|Hs108|chr1	CCDS30653.1|Hs108|chr1	1.01e-121	51	90.196	46	5	1	2
CCDS41425.1|Hs108|chr1	CCDS30919.1|Hs108|chr1	0	55	100	55	0	-1	-2
CCDS41686.1|Hs108|chr11	CCDS59092.1|Hs108|chr8	1.43e-66	80	83.75	67	13	3	1
CCDS41686.1|Hs108|chr11	CCDS59092.1|Hs108|chr8	4e-38	80	83.75	67	13	-3	-2
CCDS41686.1|Hs108|chr11	CCDS10529.1|Hs108|chr16	2.97e-67	80	80	64	16	3	1
CCDS41686.1|Hs108|chr11	CCDS10529.1|Hs108|chr16	1.25e-36	80	80	64	16	-3	-2
CCDS41767.1|Hs108|chr12	CCDS44856.1|Hs108|chr12	0	90	96.667	87	3	-2	-1
CCDS41927.1|Hs108|chr14	CCDS9604.1|Hs108|chr14	0	56	100	56	0	3	1
CCDS41927.1|Hs108|chr14	CCDS9604.1|Hs108|chr14	0	56	100	56	0	-2	-1
CCDS41927.1|Hs108|chr14	CCDS9604.1|Hs108|chr14	1.69e-177	56	100	56	0	-3	-2
CCDS41927.1|Hs108|chr14	CCDS9604.1|Hs108|chr14	6.26e-170	56	100	56	0	2	3
CCDS42108.1|Hs108|chr16	CCDS53984.1|Hs108|chr16	1.73e-103	143	100	143	0	3	-1
CCDS42108.1|Hs108|chr16	CCDS53984.1|Hs108|chr16	6.64e-100	143	100	143	0	-1	3
CCDS42108.1|Hs108|chr16	CCDS53984.1|Hs108|chr16	6.68e-88	143	100	143	0	1	-2
CCDS42175.1|Hs108|chr16	CCDS45510.1|Hs108|chr16	1.84e-24	57	82.456	47	10	1	3
CCDS42176.1|Hs108|chr16	CCDS58473.1|Hs108|chr16	4.83e-99	113	98.23	111	2	2	1
CCDS42348.1|Hs108|chr17	CCDS45710.1|Hs108|chr17	4.86e-180	85	100	85	0	1	3
CCDS42348.1|Hs108|chr17	CCDS45711.1|Hs108|chr17	1.44e-170	63	100	63	0	1	3
CCDS42402.1|Hs108|chr17	CCDS82231.1|Hs108|chr17	0	134	100	134	0	3	1
CCDS42498.1|Hs108|chr19	CCDS56082.1|Hs108|chr19	0	74	100	74	0	3	2
CCDS42500.1|Hs108|chr19	CCDS32904.1|Hs108|chr19	3.28e-136	82	93.902	77	5	-1	-3
CCDS42551.1|Hs108|chr19	CCDS12473.1|Hs108|chr19	1.13e-67	61	100	61	0	-1	-2
CCDS42580.2|Hs108|chr19	CCDS12682.1|Hs108|chr19	0	51	100	51	0	-2	-1
CCDS42580.2|Hs108|chr19	CCDS12682.1|Hs108|chr19	0	51	100	51	0	3	1
CCDS42580.2|Hs108|chr19	CCDS12681.2|Hs108|chr19	0	51	100	51	0	-2	-1
CCDS42580.2|Hs108|chr19	CCDS12681.2|Hs108|chr19	0	51	100	51	0	3	1
CCDS42626.1|Hs108|chr19	CCDS46184.1|Hs108|chr19	0	82	100	82	0	-3	-1
CCDS42626.1|Hs108|chr19	CCDS58678.1|Hs108|chr19	0	82	100	82	0	-3	-1
CCDS42661.1|Hs108|chr2	CCDS82429.1|Hs108|chr2	1.7e-118	173	100	173	0	-2	-1
CCDS42736.1|Hs108|chr2	CCDS46398.1|Hs108|chr2	0	64	98.438	63	1	3	1
CCDS42886.1|Hs108|chr20	CCDS54470.1|Hs108|chr20	0	66	92.424	61	5	-1	-2
CCDS43013.1|Hs108|chr22	CCDS13921.1|Hs108|chr22	0	69	100	69	0	-1	-2
CCDS43087.1|Hs108|chr3	CCDS63628.1|Hs108|chr3	0	56	100	56	0	-1	-3
CCDS43307.1|Hs108|chr5	CCDS45557.1|Hs108|chr16	0	126	96.032	121	5	1	3
CCDS43308.1|Hs108|chr5	CCDS75232.1|Hs108|chr5	2.98e-148	59	96.61	57	2	1	2
CCDS43623.1|Hs108|chr7	CCDS59067.1|Hs108|chr7	0	68	80.882	55	13	1	3
CCDS43737.1|Hs108|chr8	CCDS64890.1|Hs108|chr8	0	54	90.741	49	5	2	3
CCDS43885.1|Hs108|chr9	CCDS6914.1|Hs108|chr9	0	140	100	140	0	3	2
CCDS43885.1|Hs108|chr9	CCDS6914.1|Hs108|chr9	0	140	100	140	0	1	3
CCDS43885.1|Hs108|chr9	CCDS6914.1|Hs108|chr9	0	140	100	140	0	-2	-3
CCDS43885.1|Hs108|chr9	CCDS6914.1|Hs108|chr9	0	140	100	140	0	-3	-1
CCDS43885.1|Hs108|chr9	CCDS6914.1|Hs108|chr9	3.09e-177	140	100	140	0	-1	-2
CCDS43886.1|Hs108|chr9	CCDS6914.1|Hs108|chr9	0	140	100	140	0	3	2
CCDS43886.1|Hs108|chr9	CCDS6914.1|Hs108|chr9	2.82e-177	140	100	140	0	1	3
CCDS43886.1|Hs108|chr9	CCDS6914.1|Hs108|chr9	1.07e-173	140	100	140	0	-2	-3
CCDS43886.1|Hs108|chr9	CCDS6914.1|Hs108|chr9	4.69e-168	140	100	140	0	-3	-1
CCDS43886.1|Hs108|chr9	CCDS6914.1|Hs108|chr9	2.59e-161	140	100	140	0	-1	-2
CCDS44041.1|Hs108|chr1	CCDS55560.1|Hs108|chr1	7.95e-134	57	85.965	49	8	-1	-3
CCDS44041.1|Hs108|chr1	CCDS33.1|Hs108|chr1	3.63e-134	62	80.645	50	12	-1	-3
CCDS44051.1|Hs108|chr1	CCDS44049.1|Hs108|chr1	0	77	100	77	0	-1	-2
CCDS44056.1|Hs108|chr1	CCDS30585.1|Hs108|chr1	5.37e-76	103	100	103	0	1	3
CCDS44056.1|Hs108|chr1	CCDS30585.1|Hs108|chr1	6.4e-71	103	100	103	0	-1	-2
CCDS44089.1|Hs108|chr1	CCDS41284.1|Hs108|chr1	5.97e-145	56	100	56	0	-1	-3
CCDS44089.1|Hs108|chr1	CCDS41284.1|Hs108|chr1	1.5e-129	56	100	56	0	1	2
CCDS44089.1|Hs108|chr1	CCDS41284.1|Hs108|chr1	5.9e-125	56	100	56	0	-2	-1
CCDS44125.1|Hs108|chr1	CCDS53306.1|Hs108|chr1	2.16e-69	56	96.429	54	2	2	1
CCDS44236.1|Hs108|chr1	CCDS58032.1|Hs108|chr1	5.07e-23	53	83.019	44	9	2	1
CCDS44238.1|Hs108|chr1	CCDS44239.1|Hs108|chr1	7.43e-55	52	80.769	42	10	-3	-2
CCDS44246.1|Hs108|chr1	CCDS1154.1|Hs108|chr1	5.79e-176	67	98.507	66	1	1	3
CCDS44313.1|Hs108|chr1	CCDS44312.1|Hs108|chr1	1.1e-21	50	86	43	7	-2	-3
CCDS44559.1|Hs108|chr11	CCDS73269.1|Hs108|chr11	1.45e-141	92	89.13	82	10	-1	-3
CCDS44571.1|Hs108|chr11	CCDS76395.1|Hs108|chr11	4.63e-70	82	97.561	80	2	1	2
CCDS44627.1|Hs108|chr11	CCDS55769.1|Hs108|chr11	6.4e-172	72	93.056	67	5	1	3
CCDS44642.2|Hs108|chr11	CCDS53661.1|Hs108|chr11	0	83	100	83	0	3	2
CCDS44642.2|Hs108|chr11	CCDS53660.1|Hs108|chr11	0	80	100	80	0	3	2
CCDS44648.1|Hs108|chr11	CCDS53662.1|Hs108|chr11	1.6e-54	55	100	55	0	-1	-2
CCDS44664.1|Hs108|chr11	CCDS59512.1|Hs108|chr8	4.27e-92	80	88.75	71	9	1	2
CCDS44836.1|Hs108|chr12	CCDS55808.1|Hs108|chr12	8.14e-178	121	99.174	120	1	3	2
CCDS44856.1|Hs108|chr12	CCDS58224.1|Hs108|chr12	0	90	96.667	87	3	-1	-2
CCDS44856.1|Hs108|chr12	CCDS41767.1|Hs108|chr12	0	90	96.667	87	3	-1	-2
CCDS45143.1|Hs108|chr14	CCDS9864.1|Hs108|chr14	5.53e-168	84	100	84	0	-1	-3
CCDS45143.1|Hs108|chr14	CCDS9864.1|Hs108|chr14	8.56e-166	84	100	84	0	3	1
CCDS45143.1|Hs108|chr14	CCDS9864.1|Hs108|chr14	2.94e-127	84	100	84	0	1	2
CCDS45143.1|Hs108|chr14	CCDS9864.1|Hs108|chr14	1.25e-118	84	100	84	0	-2	-1
CCDS45230.1|Hs108|chr15	CCDS10066.1|Hs108|chr15	8.6e-93	63	96.825	61	2	2	3
CCDS45367.1|Hs108|chr16	CCDS42091.1|Hs108|chr16	1.15e-71	63	100	63	0	-1	-3
CCDS45367.1|Hs108|chr16	CCDS42091.1|Hs108|chr16	1.19e-59	63	100	63	0	1	2
CCDS45367.1|Hs108|chr16	CCDS42091.1|Hs108|chr16	1.35e-39	63	100	63	0	-2	-1
CCDS45421.1|Hs108|chr16	CCDS10560.1|Hs108|chr16	4.54e-34	56	82.143	46	10	-3	-2
CCDS45443.1|Hs108|chr16	CCDS81968.1|Hs108|chr16	0	262	97.328	255	7	3	1
CCDS45510.1|Hs108|chr16	CCDS42175.1|Hs108|chr16	1.08e-24	57	82.456	47	10	3	1
CCDS45547.2|Hs108|chr16	CCDS73925.1|Hs108|chr16	5.2e-27	62	98.387	61	1	3	2
CCDS45557.1|Hs108|chr16	CCDS43307.1|Hs108|chr5	0	126	96.032	121	5	3	1
CCDS45564.1|Hs108|chr17	CCDS11007.1|Hs108|chr17	2.92e-63	84	92.857	78	6	-3	-2
CCDS45620.1|Hs108|chr17	CCDS11178.2|Hs108|chr17	7.64e-95	89	98.876	88	1	-2	-1
CCDS45624.1|Hs108|chr17	CCDS45625.1|Hs108|chr17	7.23e-134	103	100	103	0	2	3
CCDS45624.1|Hs108|chr17	CCDS45625.1|Hs108|chr17	8.88e-116	103	100	103	0	-1	-3
CCDS45624.1|Hs108|chr17	CCDS45625.1|Hs108|chr17	1.37e-101	103	100	103	0	1	2
CCDS45625.1|Hs108|chr17	CCDS45624.1|Hs108|chr17	2.81e-134	103	100	103	0	3	2
CCDS45625.1|Hs108|chr17	CCDS45624.1|Hs108|chr17	1.62e-114	103	100	103	0	-3	-1
CCDS45625.1|Hs108|chr17	CCDS45624.1|Hs108|chr17	5.31e-102	103	100	103	0	2	1
CCDS45625.1|Hs108|chr17	CCDS11193.1|Hs108|chr17	2.81e-134	103	100	103	0	3	2
CCDS45625.1|Hs108|chr17	CCDS11193.1|Hs108|chr17	1.62e-114	103	100	103	0	-3	-1
CCDS45625.1|Hs108|chr17	CCDS11193.1|Hs108|chr17	5.31e-102	103	100	103	0	2	1
CCDS45626.1|Hs108|chr17	CCDS82207.1|Hs108|chr17	2.44e-114	89	86.517	77	12	-1	-2
CCDS45626.1|Hs108|chr17	CCDS11737.1|Hs108|chr17	2.44e-114	89	86.517	77	12	-1	-2
CCDS45710.1|Hs108|chr17	CCDS42348.1|Hs108|chr17	0	93	98.925	92	1	3	1
CCDS45711.1|Hs108|chr17	CCDS42348.1|Hs108|chr17	2.31e-171	62	100	62	0	-3	-2
CCDS45757.1|Hs108|chr17	CCDS11647.1|Hs108|chr17	2.18e-129	66	100	66	0	3	1
CCDS45757.1|Hs108|chr17	CCDS11647.1|Hs108|chr17	1.45e-128	66	100	66	0	-2	-1
CCDS45757.1|Hs108|chr17	CCDS45758.1|Hs108|chr17	5e-121	66	100	66	0	-2	-1
CCDS45757.1|Hs108|chr17	CCDS45758.1|Hs108|chr17	4.27e-116	66	100	66	0	3	1
CCDS45758.1|Hs108|chr17	CCDS45757.1|Hs108|chr17	8.17e-122	66	100	66	0	-1	-2
CCDS45758.1|Hs108|chr17	CCDS45757.1|Hs108|chr17	1.61e-118	66	100	66	0	1	3
CCDS46024.1|Hs108|chr19	CCDS12394.1|Hs108|chr19	3.67e-151	64	87.5	56	8	1	3
CCDS46117.1|Hs108|chr19	CCDS46118.1|Hs108|chr19	0	79	100	79	0	-3	-2
CCDS46118.1|Hs108|chr19	CCDS46117.1|Hs108|chr19	0	82	97.561	80	2	2	1
CCDS46129.1|Hs108|chr19	CCDS12697.1|Hs108|chr19	5.42e-82	98	100	98	0	2	1
CCDS46129.1|Hs108|chr19	CCDS46130.1|Hs108|chr19	1.17e-73	98	100	98	0	2	1
CCDS46130.1|Hs108|chr19	CCDS46129.1|Hs108|chr19	4.24e-78	103	100	103	0	1	2
CCDS46184.1|Hs108|chr19	CCDS42626.1|Hs108|chr19	0	82	100	82	0	-1	-3
CCDS46398.1|Hs108|chr2	CCDS46399.1|Hs108|chr2	0	94	100	94	0	1	3
CCDS46398.1|Hs108|chr2	CCDS42736.1|Hs108|chr2	0	60	98.333	59	1	1	3
CCDS46399.1|Hs108|chr2	CCDS46398.1|Hs108|chr2	0	100	100	100	0	3	1
CCDS46449.1|Hs108|chr2	CCDS2244.1|Hs108|chr2	8.23e-46	95	98.947	94	1	-2	-3
CCDS46449.1|Hs108|chr2	CCDS58736.1|Hs108|chr2	8.23e-46	95	98.947	94	1	-2	-3
CCDS46699.1|Hs108|chr22	CCDS46700.1|Hs108|chr22	0	69	100	69	0	-2	-1
CCDS46699.1|Hs108|chr22	CCDS46701.1|Hs108|chr22	0	69	100	69	0	-2	-1
CCDS46700.1|Hs108|chr22	CCDS46699.1|Hs108|chr22	0	69	100	69	0	-1	-2
CCDS46701.1|Hs108|chr22	CCDS46699.1|Hs108|chr22	0	69	100	69	0	-1	-2
CCDS46824.1|Hs108|chr3	CCDS63628.1|Hs108|chr3	0	56	100	56	0	-1	-3
CCDS46825.1|Hs108|chr3	CCDS63628.1|Hs108|chr3	0	56	100	56	0	-1	-3
CCDS46826.1|Hs108|chr3	CCDS63628.1|Hs108|chr3	0	56	100	56	0	-1	-3
CCDS46841.1|Hs108|chr3	CCDS2852.1|Hs108|chr3	2.3e-117	60	98.333	59	1	2	1
CCDS46881.1|Hs108|chr3	CCDS63712.1|Hs108|chr3	0	317	96.53	306	11	2	1
CCDS46899.1|Hs108|chr3	CCDS3042.1|Hs108|chr3	0	91	100	91	0	-3	-1
CCDS46899.1|Hs108|chr3	CCDS3042.1|Hs108|chr3	8.02e-170	91	100	91	0	2	1
CCDS47027.2|Hs108|chr4	CCDS54744.1|Hs108|chr4	3.15e-53	51	94.118	48	3	1	3
CCDS47064.1|Hs108|chr4	CCDS3517.1|Hs108|chr4	3.94e-128	77	100	77	0	1	3
CCDS47064.1|Hs108|chr4	CCDS3517.1|Hs108|chr4	6.31e-121	77	100	77	0	-1	-2
CCDS47698.2|Hs108|chr7	CCDS55160.1|Hs108|chr7	0	61	100	61	0	1	3
CCDS47698.2|Hs108|chr7	CCDS55160.1|Hs108|chr7	0	61	100	61	0	-3	-1
CCDS47698.2|Hs108|chr7	CCDS55160.1|Hs108|chr7	0	61	100	61	0	-1	-2
CCDS47713.1|Hs108|chr7	CCDS5819.1|Hs108|chr7	0	59	98.305	58	1	-1	-3
CCDS53306.1|Hs108|chr1	CCDS44125.1|Hs108|chr1	1.2e-114	55	100	55	0	2	3
CCDS53306.1|Hs108|chr1	CCDS471.1|Hs108|chr1	5.26e-113	54	98.148	53	1	3	1
CCDS53467.1|Hs108|chr1	CCDS1473.1|Hs108|chr1	0	69	100	69	0	-3	-1
CCDS53467.1|Hs108|chr1	CCDS44304.1|Hs108|chr1	1.68e-105	69	100	69	0	-3	-1
CCDS53635.1|Hs108|chr11	CCDS76407.1|Hs108|chr11	0	55	96.364	53	2	2	1
CCDS53660.1|Hs108|chr11	CCDS44642.2|Hs108|chr11	0	80	100	80	0	2	3
CCDS53661.1|Hs108|chr11	CCDS44642.2|Hs108|chr11	0	83	100	83	0	2	3
CCDS53662.1|Hs108|chr11	CCDS44648.1|Hs108|chr11	6.54e-74	54	100	54	0	2	3
CCDS53662.1|Hs108|chr11	CCDS44648.1|Hs108|chr11	3.51e-28	54	100	54	0	-1	-3
CCDS53745.1|Hs108|chr12	CCDS8618.1|Hs108|chr12	1.17e-99	52	86.538	45	7	-2	-3
CCDS53757.1|Hs108|chr12	CCDS8683.1|Hs108|chr12	2.25e-31	63	95.238	60	3	-1	-2
CCDS53758.1|Hs108|chr12	CCDS53759.1|Hs108|chr12	0	63	95.238	60	3	-2	-1
CCDS53759.1|Hs108|chr12	CCDS8683.1|Hs108|chr12	1.86e-31	63	95.238	60	3	-1	-2
CCDS53851.1|Hs108|chr12	CCDS45012.1|Hs108|chr12	2.77e-110	92	98.913	91	1	-1	-3
CCDS53853.1|Hs108|chr12	CCDS45012.1|Hs108|chr12	5.51e-65	91	100	91	0	3	1
CCDS54049.1|Hs108|chr16	CCDS58491.1|Hs108|chr16	1.92e-74	50	98	49	1	1	2
CCDS54117.1|Hs108|chr17	CCDS11341.1|Hs108|chr17	2.11e-25	76	81.579	62	14	1	2
CCDS54194.1|Hs108|chr18	CCDS12021.1|Hs108|chr18	5.48e-164	82	97.561	80	2	-1	-3
CCDS54315.1|Hs108|chr19	CCDS12883.1|Hs108|chr19	3.03e-19	50	82	41	9	-2	-3
CCDS54315.1|Hs108|chr19	CCDS54316.1|Hs108|chr19	3.03e-19	50	82	41	9	-2	-3
CCDS54373.1|Hs108|chr2	CCDS1989.1|Hs108|chr2	8.99e-83	66	96.97	64	2	-1	-3
CCDS54373.1|Hs108|chr2	CCDS54374.1|Hs108|chr2	3.76e-73	66	96.97	64	2	-1	-3
CCDS54470.1|Hs108|chr20	CCDS42886.1|Hs108|chr20	0	66	92.424	61	5	-2	-1
CCDS54470.1|Hs108|chr20	CCDS13400.1|Hs108|chr20	0	66	92.424	61	5	-2	-1
CCDS54552.1|Hs108|chr3	CCDS2589.1|Hs108|chr3	0	78	100	78	0	-1	-2
CCDS54639.1|Hs108|chr3	CCDS3069.1|Hs108|chr3	0	60	100	60	0	-1	-3
CCDS54654.1|Hs108|chr3	CCDS54655.1|Hs108|chr3	2.76e-165	58	100	58	0	-2	-3
CCDS54654.1|Hs108|chr3	CCDS54655.1|Hs108|chr3	3.22e-163	58	100	58	0	1	3
CCDS54654.1|Hs108|chr3	CCDS54655.1|Hs108|chr3	6.99e-137	58	100	58	0	-1	-2
CCDS54655.1|Hs108|chr3	CCDS3139.1|Hs108|chr3	1.66e-176	59	98.305	58	1	-1	-3
CCDS54655.1|Hs108|chr3	CCDS3139.1|Hs108|chr3	5.7e-168	59	98.305	58	1	2	3
CCDS54655.1|Hs108|chr3	CCDS54654.1|Hs108|chr3	5.61e-176	58	100	58	0	-3	-2
CCDS54655.1|Hs108|chr3	CCDS54654.1|Hs108|chr3	2.58e-163	58	100	58	0	3	1
CCDS54655.1|Hs108|chr3	CCDS54654.1|Hs108|chr3	5.49e-137	58	100	58	0	-2	-1
CCDS54693.1|Hs108|chr3	CCDS77867.1|Hs108|chr3	0	128	100	128	0	-1	-3
CCDS54698.1|Hs108|chr3	CCDS33921.1|Hs108|chr3	0	60	98.333	59	1	1	2
CCDS54698.1|Hs108|chr3	CCDS3308.2|Hs108|chr3	0	53	100	53	0	-2	-1
CCDS54698.1|Hs108|chr3	CCDS3308.2|Hs108|chr3	0	53	100	53	0	3	1
CCDS54699.1|Hs108|chr3	CCDS54698.1|Hs108|chr3	0	60	98.333	59	1	2	1
CCDS54717.1|Hs108|chr4	CCDS3370.2|Hs108|chr4	1.3e-139	90	91.111	82	8	2	1
CCDS54744.1|Hs108|chr4	CCDS47027.2|Hs108|chr4	9.52e-56	51	94.118	48	3	3	1
CCDS54836.1|Hs108|chr5	CCDS3903.1|Hs108|chr5	7.9800000000000006e-129	69	100	69	0	3	1
CCDS54836.1|Hs108|chr5	CCDS3903.1|Hs108|chr5	7.54e-61	69	100	69	0	-3	-2
CCDS54892.1|Hs108|chr5	CCDS54891.1|Hs108|chr5	0	51	82.353	42	9	2	3
CCDS55005.1|Hs108|chr6	CCDS4905.1|Hs108|chr6	2.8e-144	56	98.214	55	1	-1	-2
CCDS55005.1|Hs108|chr6	CCDS4905.1|Hs108|chr6	1.46e-134	56	98.214	55	1	2	1
CCDS55016.1|Hs108|chr6	CCDS34459.1|Hs108|chr6	7.76e-62	72	91.667	66	6	-2	-3
CCDS55160.1|Hs108|chr7	CCDS47698.2|Hs108|chr7	0	61	100	61	0	3	1
CCDS55160.1|Hs108|chr7	CCDS47698.2|Hs108|chr7	0	61	100	61	0	-2	-1
CCDS55324.1|Hs108|chr9	CCDS6677.1|Hs108|chr9	7.68e-169	77	100	77	0	3	1
CCDS55324.1|Hs108|chr9	CCDS35060.1|Hs108|chr9	8.2e-169	77	100	77	0	3	1
CCDS55324.1|Hs108|chr9	CCDS6678.1|Hs108|chr9	8.36e-164	77	100	77	0	3	1
CCDS55510.1|Hs108|chrX	CCDS14661.1|Hs108|chrX	2.09e-92	110	99.091	109	1	1	2
CCDS55510.1|Hs108|chrX	CCDS716.1|Hs108|chr1	2.51e-87	117	91.453	107	10	1	2
CCDS55518.1|Hs108|chrX	CCDS14682.1|Hs108|chrX	0	80	100	80	0	-2	-1
CCDS55518.1|Hs108|chrX	CCDS76039.1|Hs108|chrX	0	80	100	80	0	-2	-1
CCDS55519.1|Hs108|chrX	CCDS55518.1|Hs108|chrX	0	80	100	80	0	-1	-2
CCDS55548.1|Hs108|chrX	CCDS14770.4|Hs108|chrY	2.1e-115	54	100	54	0	2	1
CCDS55548.1|Hs108|chrY	CCDS14770.4|Hs108|chrY	2.1e-115	54	100	54	0	2	1
CCDS55558.1|Hs108|chr1	CCDS57962.1|Hs108|chr1	3.46e-99	108	98.148	106	2	-1	-2
CCDS55560.1|Hs108|chr1	CCDS44041.1|Hs108|chr1	1.41e-123	53	92.453	49	4	-2	-3
CCDS55649.1|Hs108|chr1	CCDS30886.1|Hs108|chr1	5.55e-106	58	100	58	0	1	2
CCDS55650.1|Hs108|chr1	CCDS60299.1|Hs108|chr1	2.91e-103	63	100	63	0	3	1
CCDS55698.1|Hs108|chr10	CCDS7059.1|Hs108|chr10	0	53	96.226	51	2	3	2
CCDS55769.1|Hs108|chr11	CCDS44627.1|Hs108|chr11	3.75e-172	72	93.056	67	5	3	1
CCDS55769.1|Hs108|chr11	CCDS8031.1|Hs108|chr11	3.75e-172	72	93.056	67	5	3	1
CCDS55829.1|Hs108|chr12	CCDS8858.1|Hs108|chr12	0	50	100	50	0	1	2
CCDS55829.1|Hs108|chr12	CCDS8858.1|Hs108|chr12	0	50	100	50	0	-2	-1
CCDS55829.1|Hs108|chr12	CCDS8858.1|Hs108|chr12	0	50	100	50	0	-1	-3
CCDS55883.1|Hs108|chr12	CCDS31897.1|Hs108|chr12	9.9e-104	66	100	66	0	1	2
CCDS55883.1|Hs108|chr12	CCDS31897.1|Hs108|chr12	9.08e-68	66	100	66	0	-2	-1
CCDS55883.1|Hs108|chr12	CCDS31897.1|Hs108|chr12	1.05e-24	66	100	66	0	-1	-3
CCDS55972.1|Hs108|chr15	CCDS32284.1|Hs108|chr15	0	54	96.296	52	2	-2	-1
CCDS55972.1|Hs108|chr15	CCDS32285.1|Hs108|chr15	0	54	96.296	52	2	-2	-1
CCDS56082.1|Hs108|chr19	CCDS42498.1|Hs108|chr19	0	74	100	74	0	-2	-1
CCDS56082.1|Hs108|chr19	CCDS42498.1|Hs108|chr19	0	74	100	74	0	3	1
CCDS56082.1|Hs108|chr19	CCDS42498.1|Hs108|chr19	0	74	100	74	0	-3	-2
CCDS56099.1|Hs108|chr19	CCDS59409.1|Hs108|chr19	0	101	100	101	0	-2	-1
CCDS56099.1|Hs108|chr19	CCDS59409.1|Hs108|chr19	0	101	100	101	0	1	2
CCDS56107.1|Hs108|chr19	CCDS42640.1|Hs108|chr19	2.28e-141	202	99.01	200	2	-1	-3
CCDS56107.1|Hs108|chr19	CCDS56108.1|Hs108|chr19	3.63e-139	202	99.01	200	2	-1	-3
CCDS56108.1|Hs108|chr19	CCDS56107.1|Hs108|chr19	6.9e-139	202	99.01	200	2	-3	-1
CCDS56108.1|Hs108|chr19	CCDS56107.1|Hs108|chr19	8.76e-130	202	99.01	200	2	2	1
CCDS56108.1|Hs108|chr19	CCDS56107.1|Hs108|chr19	1.65e-129	202	99.01	200	2	-1	-2
CCDS56112.1|Hs108|chr2	CCDS1708.1|Hs108|chr2	4.82e-27	57	82.456	47	10	-2	-3
CCDS56204.1|Hs108|chr21	CCDS56205.1|Hs108|chr21	5.69e-159	62	100	62	0	1	3
CCDS56204.1|Hs108|chr21	CCDS56205.1|Hs108|chr21	1.21e-155	62	100	62	0	3	2
CCDS56204.1|Hs108|chr21	CCDS56205.1|Hs108|chr21	6.66e-149	62	100	62	0	-1	-2
CCDS56205.1|Hs108|chr21	CCDS33519.1|Hs108|chr21	1.43e-169	63	100	63	0	-1	-3
CCDS56205.1|Hs108|chr21	CCDS33519.1|Hs108|chr21	9.51e-161	63	100	63	0	3	1
CCDS56205.1|Hs108|chr21	CCDS33519.1|Hs108|chr21	1.21e-156	63	100	63	0	2	3
CCDS56205.1|Hs108|chr21	CCDS33519.1|Hs108|chr21	4.9e-150	63	100	63	0	-2	-1
CCDS56205.1|Hs108|chr21	CCDS56204.1|Hs108|chr21	3.12e-160	62	100	62	0	3	1
CCDS56205.1|Hs108|chr21	CCDS56204.1|Hs108|chr21	7.81e-156	62	100	62	0	2	3
CCDS56205.1|Hs108|chr21	CCDS56204.1|Hs108|chr21	4.34e-149	62	100	62	0	-2	-1
CCDS56206.1|Hs108|chr21	CCDS33519.1|Hs108|chr21	6.04e-30	65	80	52	13	1	2
CCDS56206.1|Hs108|chr21	CCDS56204.1|Hs108|chr21	6.04e-30	65	80	52	13	1	2
CCDS56220.1|Hs108|chr21	CCDS68231.1|Hs108|chr21	1.1e-180	73	95.89	70	3	1	2
CCDS56220.1|Hs108|chr21	CCDS68231.1|Hs108|chr21	5.8e-173	73	95.89	70	3	-2	-1
CCDS56224.1|Hs108|chr22	CCDS13764.1|Hs108|chr22	0	67	100	67	0	1	3
CCDS56224.1|Hs108|chr22	CCDS13764.1|Hs108|chr22	0	67	100	67	0	-1	-2
CCDS56334.1|Hs108|chr4	CCDS3569.1|Hs108|chr4	4.08e-71	111	99.099	110	1	-3	-2
CCDS56334.1|Hs108|chr4	CCDS75142.1|Hs108|chr4	3.84e-23	50	96	48	2	-3	-2
CCDS56376.1|Hs108|chr5	CCDS4108.1|Hs108|chr5	1.76e-43	69	95.652	66	3	2	3
CCDS56376.1|Hs108|chr5	CCDS56375.1|Hs108|chr5	1.8e-43	66	95.455	63	3	2	3
CCDS56433.1|Hs108|chr6	CCDS75470.1|Hs108|chr6	8.7e-175	93	100	93	0	1	2
CCDS56433.1|Hs108|chr6	CCDS75470.1|Hs108|chr6	3.31e-169	93	100	93	0	-1	-3
CCDS57962.1|Hs108|chr1	CCDS55558.1|Hs108|chr1	2.31e-100	108	98.148	106	2	-2	-1
CCDS57965.1|Hs108|chr1	CCDS38.2|Hs108|chr1	2.3e-73	91	100	91	0	-1	-3
CCDS57965.1|Hs108|chr1	CCDS72687.1|Hs108|chr1	7.66e-73	91	98.901	90	1	-1	-3
CCDS57979.1|Hs108|chr1	CCDS57980.1|Hs108|chr1	1.22e-109	55	96.364	53	2	-3	-1
CCDS57980.1|Hs108|chr1	CCDS57979.1|Hs108|chr1	1.82e-89	52	100	52	0	1	2
CCDS57980.1|Hs108|chr1	CCDS254.1|Hs108|chr1	8.76e-21	52	100	52	0	1	2
CCDS57982.1|Hs108|chr1	CCDS57979.1|Hs108|chr1	9.26e-60	58	89.655	52	6	2	3
CCDS57982.1|Hs108|chr1	CCDS254.1|Hs108|chr1	1.01e-59	58	89.655	52	6	2	3
CCDS58032.1|Hs108|chr1	CCDS44236.1|Hs108|chr1	4.66e-23	53	83.019	44	9	1	2
CCDS58102.1|Hs108|chr10	CCDS58103.1|Hs108|chr10	0	82	87.805	72	10	-1	-3
CCDS58102.1|Hs108|chr10	CCDS31319.2|Hs108|chr10	0	79	100	79	0	2	1
CCDS58103.1|Hs108|chr10	CCDS31319.2|Hs108|chr10	0	94	100	94	0	-3	-1
CCDS58103.1|Hs108|chr10	CCDS58102.1|Hs108|chr10	0	79	100	79	0	1	2
CCDS58150.1|Hs108|chr11	CCDS8162.1|Hs108|chr11	0	103	94.175	97	6	2	1
CCDS58152.1|Hs108|chr11	CCDS8215.1|Hs108|chr11	0	71	100	71	0	1	3
CCDS58152.1|Hs108|chr11	CCDS58154.1|Hs108|chr11	0	71	100	71	0	1	3
CCDS58153.1|Hs108|chr11	CCDS58152.1|Hs108|chr11	0	71	100	71	0	3	1
CCDS58153.1|Hs108|chr11	CCDS58152.1|Hs108|chr11	2.31e-37	71	100	71	0	1	2
CCDS58154.1|Hs108|chr11	CCDS58152.1|Hs108|chr11	0	71	100	71	0	3	1
CCDS58224.1|Hs108|chr12	CCDS44856.1|Hs108|chr12	0	90	96.667	87	3	-2	-1
CCDS58320.1|Hs108|chr14	CCDS73639.1|Hs108|chr14	0	51	100	51	0	1	3
CCDS58320.1|Hs108|chr14	CCDS73639.1|Hs108|chr14	0	51	100	51	0	-2	-3
CCDS58320.1|Hs108|chr14	CCDS73639.1|Hs108|chr14	0	51	100	51	0	-1	-2
CCDS58320.1|Hs108|chr14	CCDS73639.1|Hs108|chr14	0	51	100	51	0	2	1
CCDS58320.1|Hs108|chr14	CCDS58322.1|Hs108|chr14	0	51	100	51	0	1	3
CCDS58320.1|Hs108|chr14	CCDS58322.1|Hs108|chr14	0	51	100	51	0	-2	-3
CCDS58320.1|Hs108|chr14	CCDS58322.1|Hs108|chr14	0	51	100	51	0	-1	-2
CCDS58320.1|Hs108|chr14	CCDS58322.1|Hs108|chr14	0	51	100	51	0	2	1
CCDS58320.1|Hs108|chr14	CCDS58321.1|Hs108|chr14	0	51	100	51	0	1	3
CCDS58320.1|Hs108|chr14	CCDS58321.1|Hs108|chr14	0	51	100	51	0	-2	-3
CCDS58320.1|Hs108|chr14	CCDS58321.1|Hs108|chr14	0	51	100	51	0	-1	-2
CCDS58320.1|Hs108|chr14	CCDS58321.1|Hs108|chr14	0	51	100	51	0	2	1
CCDS58392.1|Hs108|chr15	CCDS10306.1|Hs108|chr15	1.09e-92	55	98.182	54	1	3	1
CCDS58412.1|Hs108|chr16	CCDS58413.1|Hs108|chr16	0	55	100	55	0	2	1
CCDS58413.1|Hs108|chr16	CCDS58412.1|Hs108|chr16	0	54	100	54	0	-3	-2
CCDS58413.1|Hs108|chr16	CCDS58412.1|Hs108|chr16	1.97e-148	54	100	54	0	3	1
CCDS58422.1|Hs108|chr16	CCDS10540.1|Hs108|chr16	0	52	96.154	50	2	1	2
CCDS58440.1|Hs108|chr16	CCDS58439.1|Hs108|chr16	0	85	96.471	82	3	1	3
CCDS58440.1|Hs108|chr16	CCDS58438.1|Hs108|chr16	0	85	96.471	82	3	1	3
CCDS58449.1|Hs108|chr16	CCDS10664.1|Hs108|chr16	9.44e-99	76	100	76	0	-2	-3
CCDS58449.1|Hs108|chr16	CCDS10664.1|Hs108|chr16	4.64e-77	76	100	76	0	-1	-2
CCDS58473.1|Hs108|chr16	CCDS61960.1|Hs108|chr16	3.83e-99	113	98.23	111	2	1	2
CCDS58473.1|Hs108|chr16	CCDS42176.1|Hs108|chr16	3.84e-99	113	98.23	111	2	1	2
CCDS58528.1|Hs108|chr17	CCDS82088.1|Hs108|chr17	2.94e-98	134	100	134	0	1	2
CCDS58528.1|Hs108|chr17	CCDS11205.1|Hs108|chr17	1.05e-97	135	99.259	134	1	1	2
CCDS58655.1|Hs108|chr19	CCDS12365.1|Hs108|chr19	1.94e-84	63	100	63	0	1	2
CCDS58655.1|Hs108|chr19	CCDS12365.1|Hs108|chr19	8.05e-50	63	100	63	0	-1	-3
CCDS58678.1|Hs108|chr19	CCDS42626.1|Hs108|chr19	0	82	100	82	0	-1	-3
CCDS58731.1|Hs108|chr2	CCDS46413.1|Hs108|chr2	2.88e-110	75	98.667	74	1	-1	-3
CCDS58731.1|Hs108|chr2	CCDS58730.1|Hs108|chr2	2.99e-110	75	98.667	74	1	-1	-3
CCDS58736.1|Hs108|chr2	CCDS46449.1|Hs108|chr2	1.34e-45	95	98.947	94	1	-3	-2
CCDS58794.1|Hs108|chr22	CCDS42982.1|Hs108|chr22	2.02e-120	168	100	168	0	-3	-1
CCDS58799.1|Hs108|chr22	CCDS13872.1|Hs108|chr22	2.68e-51	82	100	82	0	2	1
CCDS58910.1|Hs108|chr4	CCDS3628.1|Hs108|chr4	0	66	96.97	64	2	1	2
CCDS58910.1|Hs108|chr4	CCDS3628.1|Hs108|chr4	0	66	96.97	64	2	-1	-3
CCDS59067.1|Hs108|chr7	CCDS43623.1|Hs108|chr7	0	54	100	54	0	1	2
CCDS59067.1|Hs108|chr7	CCDS43623.1|Hs108|chr7	0	54	100	54	0	-1	-3
CCDS59067.1|Hs108|chr7	CCDS43623.1|Hs108|chr7	0	54	100	54	0	-2	-1
CCDS59174.1|Hs108|chrX	CCDS14564.1|Hs108|chrX	1.16e-179	104	95.192	99	5	1	3
CCDS59180.1|Hs108|chrX	CCDS14771.4|Hs108|chrY	2.51e-179	63	95.238	60	3	-2	-1
CCDS59180.1|Hs108|chrY	CCDS14771.4|Hs108|chrY	2.51e-179	63	95.238	60	3	-2	-1
CCDS59240.1|Hs108|chr12	CCDS45012.1|Hs108|chr12	8.17e-87	66	90.909	60	6	-1	-3
CCDS59270.1|Hs108|chr16	CCDS32478.1|Hs108|chr16	5.42e-31	54	92.593	50	4	-3	-2
CCDS59271.1|Hs108|chr16	CCDS10905.1|Hs108|chr16	0	77	100	77	0	-1	-2
CCDS59271.1|Hs108|chr16	CCDS10905.1|Hs108|chr16	0	77	100	77	0	-3	-1
CCDS59271.1|Hs108|chr16	CCDS10905.1|Hs108|chr16	0	77	100	77	0	2	1
CCDS59272.1|Hs108|chr16	CCDS10905.1|Hs108|chr16	0	77	100	77	0	-1	-2
CCDS59272.1|Hs108|chr16	CCDS10905.1|Hs108|chr16	0	77	100	77	0	-3	-1
CCDS59272.1|Hs108|chr16	CCDS10905.1|Hs108|chr16	0	77	100	77	0	2	1
CCDS59276.1|Hs108|chr17	CCDS11050.1|Hs108|chr17	0	75	93.333	70	5	2	1
CCDS59276.1|Hs108|chr17	CCDS11051.1|Hs108|chr17	0	75	93.333	70	5	2	1
CCDS59291.1|Hs108|chr17	CCDS11446.1|Hs108|chr17	1.07e-120	64	100	64	0	2	1
CCDS59291.1|Hs108|chr17	CCDS11446.1|Hs108|chr17	9.41e-116	64	100	64	0	-1	-2
CCDS59291.1|Hs108|chr17	CCDS11446.1|Hs108|chr17	4.43e-111	64	100	64	0	-3	-1
CCDS59291.1|Hs108|chr17	CCDS11446.1|Hs108|chr17	1.13e-99	64	100	64	0	1	3
CCDS59301.1|Hs108|chr17	CCDS74176.1|Hs108|chr17	3.27e-170	82	96.341	79	3	-1	-3
CCDS59387.1|Hs108|chr19	CCDS12533.1|Hs108|chr19	0	76	100	76	0	-1	-3
CCDS59395.1|Hs108|chr19	CCDS12655.1|Hs108|chr19	5.27e-44	87	98.851	86	1	1	3
CCDS59395.1|Hs108|chr19	CCDS59397.1|Hs108|chr19	2.43e-60	87	98.851	86	1	1	3
CCDS59396.1|Hs108|chr19	CCDS12655.1|Hs108|chr19	4.09e-71	85	100	85	0	2	1
CCDS59397.1|Hs108|chr19	CCDS59395.1|Hs108|chr19	3.31e-60	87	98.851	86	1	3	1
CCDS59408.1|Hs108|chr19	CCDS59409.1|Hs108|chr19	0	101	100	101	0	-2	-1
CCDS59408.1|Hs108|chr19	CCDS59409.1|Hs108|chr19	0	101	100	101	0	1	2
CCDS59409.1|Hs108|chr19	CCDS12775.1|Hs108|chr19	0	111	92.793	103	8	-1	-2
CCDS59409.1|Hs108|chr19	CCDS56099.1|Hs108|chr19	0	101	100	101	0	-1	-2
CCDS59409.1|Hs108|chr19	CCDS56099.1|Hs108|chr19	0	101	100	101	0	2	1
CCDS59439.1|Hs108|chr2	CCDS2373.1|Hs108|chr2	1.85e-33	67	85.075	57	10	-1	-3
CCDS59439.1|Hs108|chr2	CCDS59440.1|Hs108|chr2	1.85e-33	67	85.075	57	10	-1	-3
CCDS59522.1|Hs108|chr9	CCDS59523.1|Hs108|chr9	0	75	100	75	0	-2	-3
CCDS59523.1|Hs108|chr9	CCDS59522.1|Hs108|chr9	1.92e-49	89	88.764	79	10	-2	-1
CCDS60299.1|Hs108|chr1	CCDS55650.1|Hs108|chr1	1.39e-106	69	100	69	0	1	3
CCDS60301.1|Hs108|chr1	CCDS1135.1|Hs108|chr1	6.93e-99	98	95.918	94	4	-1	-2
CCDS60893.1|Hs108|chr11	CCDS8234.1|Hs108|chr11	0	57	100	57	0	-1	-3
CCDS61146.1|Hs108|chr12	CCDS8895.1|Hs108|chr12	2.42e-174	62	90.323	56	6	-1	-2
CCDS61286.1|Hs108|chr12	CCDS31932.1|Hs108|chr12	0	94	100	94	0	2	1
CCDS61286.1|Hs108|chr12	CCDS31932.1|Hs108|chr12	0	94	100	94	0	-3	-1
CCDS61286.1|Hs108|chr12	CCDS31932.1|Hs108|chr12	0	94	100	94	0	-1	-2
CCDS61286.1|Hs108|chr12	CCDS31933.1|Hs108|chr12	0	94	100	94	0	2	1
CCDS61286.1|Hs108|chr12	CCDS31933.1|Hs108|chr12	0	94	100	94	0	-3	-1
CCDS61286.1|Hs108|chr12	CCDS31933.1|Hs108|chr12	0	94	100	94	0	-1	-2
CCDS61814.1|Hs108|chr16	CCDS10493.2|Hs108|chr16	0	84	100	84	0	2	1
CCDS61814.1|Hs108|chr16	CCDS10493.2|Hs108|chr16	0	84	100	84	0	-3	-1
CCDS61960.1|Hs108|chr16	CCDS58473.1|Hs108|chr16	5.82e-99	113	98.23	111	2	2	1
CCDS62498.1|Hs108|chr19	CCDS62499.1|Hs108|chr19	0	104	97.115	101	3	1	3
CCDS62498.1|Hs108|chr19	CCDS12121.1|Hs108|chr19	0	104	97.115	101	3	1	3
CCDS62529.1|Hs108|chr19	CCDS12206.1|Hs108|chr19	0	105	100	105	0	3	1
CCDS62529.1|Hs108|chr19	CCDS12206.1|Hs108|chr19	0	105	100	105	0	-3	-2
CCDS63283.1|Hs108|chr20	CCDS63284.1|Hs108|chr20	0	56	80.357	45	11	1	2
CCDS63284.1|Hs108|chr20	CCDS63283.1|Hs108|chr20	0	56	80.357	45	11	2	1
CCDS63326.1|Hs108|chr20	CCDS13515.1|Hs108|chr20	0	50	94	47	3	-2	-1
CCDS63326.1|Hs108|chr20	CCDS13516.1|Hs108|chr20	0	50	94	47	3	-2	-1
CCDS63628.1|Hs108|chr3	CCDS46826.1|Hs108|chr3	0	56	100	56	0	-3	-1
CCDS63628.1|Hs108|chr3	CCDS46826.1|Hs108|chr3	0	56	100	56	0	3	2
CCDS63632.1|Hs108|chr3	CCDS33754.1|Hs108|chr3	0	76	98.684	75	1	-1	-2
CCDS63632.1|Hs108|chr3	CCDS2783.1|Hs108|chr3	0	76	98.684	75	1	-1	-2
CCDS63712.1|Hs108|chr3	CCDS46881.1|Hs108|chr3	0	317	96.53	306	11	1	2
CCDS63712.1|Hs108|chr3	CCDS2950.1|Hs108|chr3	0	184	97.283	179	5	-3	-2
CCDS64582.1|Hs108|chr7	CCDS34589.1|Hs108|chr7	0	97	100	97	0	2	1
CCDS64663.1|Hs108|chr7	CCDS5529.1|Hs108|chr7	1.65e-89	75	100	75	0	1	3
CCDS64663.1|Hs108|chr7	CCDS5529.1|Hs108|chr7	8.13e-82	75	100	75	0	-1	-2
CCDS64663.1|Hs108|chr7	CCDS5529.1|Hs108|chr7	1.97e-79	75	100	75	0	2	1
CCDS64763.1|Hs108|chr7	CCDS5804.1|Hs108|chr7	2.73e-159	63	98.413	62	1	-2	-3
CCDS64805.1|Hs108|chr7	CCDS64806.1|Hs108|chr7	0	168	97.024	163	5	-2	-3
CCDS64805.1|Hs108|chr7	CCDS75680.1|Hs108|chr7	6.39e-133	94	94.681	89	5	-2	-1
CCDS64806.1|Hs108|chr7	CCDS5925.2|Hs108|chr7	0	141	97.163	137	4	-3	-1
CCDS64806.1|Hs108|chr7	CCDS64805.1|Hs108|chr7	8.39e-161	163	100	163	0	-1	-3
CCDS64890.1|Hs108|chr8	CCDS43737.1|Hs108|chr8	0	54	90.741	49	5	3	2
CCDS64890.1|Hs108|chr8	CCDS64891.1|Hs108|chr8	0	54	90.741	49	5	3	2
CCDS64891.1|Hs108|chr8	CCDS64890.1|Hs108|chr8	0	54	90.741	49	5	2	3
CCDS65045.1|Hs108|chr9	CCDS65047.1|Hs108|chr9	1.7e-141	55	100	55	0	1	2
CCDS65175.1|Hs108|chr9	CCDS65176.1|Hs108|chr9	0	176	99.432	175	1	1	3
CCDS65176.1|Hs108|chr9	CCDS65175.1|Hs108|chr9	0	176	99.432	175	1	3	1
CCDS65176.1|Hs108|chr9	CCDS6960.1|Hs108|chr9	0	176	99.432	175	1	3	1
CCDS65179.1|Hs108|chr9	CCDS6969.1|Hs108|chr9	4.98e-146	62	93.548	58	4	-1	-3
CCDS65192.1|Hs108|chr9	CCDS35180.1|Hs108|chr9	0	53	88.679	47	6	-1	-3
CCDS65461.1|Hs108|chr1	CCDS30653.1|Hs108|chr1	3.86e-122	51	90.196	46	5	1	2
CCDS66543.1|Hs108|chr13	CCDS31970.2|Hs108|chr13	5.43e-44	79	91.139	72	7	-2	-1
CCDS66543.1|Hs108|chr13	CCDS66545.1|Hs108|chr13	5.42e-44	79	91.139	72	7	-2	-1
CCDS66722.1|Hs108|chr14	CCDS32166.1|Hs108|chr14	5.09e-98	53	100	53	0	-3	-1
CCDS66877.1|Hs108|chr15	CCDS10381.1|Hs108|chr15	0	64	100	64	0	2	1
CCDS66900.1|Hs108|chr16	CCDS10447.2|Hs108|chr16	3.91e-50	98	96.939	95	3	-2	-1
CCDS66900.1|Hs108|chr16	CCDS32366.1|Hs108|chr16	3.91e-50	98	96.939	95	3	-2	-1
CCDS68231.1|Hs108|chr21	CCDS56220.1|Hs108|chr21	0	73	95.89	70	3	2	1
CCDS68231.1|Hs108|chr21	CCDS56220.1|Hs108|chr21	1.48e-174	73	95.89	70	3	-1	-2
CCDS68231.1|Hs108|chr21	CCDS13737.1|Hs108|chr21	2.86e-180	73	95.89	70	3	2	1
CCDS68231.1|Hs108|chr21	CCDS13737.1|Hs108|chr21	7.32e-173	73	95.89	70	3	-1	-2
CCDS68390.1|Hs108|chr3	CCDS68391.1|Hs108|chr3	0	67	100	67	0	1	3
CCDS68390.1|Hs108|chr3	CCDS68391.1|Hs108|chr3	0	67	100	67	0	3	2
CCDS68391.1|Hs108|chr3	CCDS2689.1|Hs108|chr3	0	67	100	67	0	3	1
CCDS68391.1|Hs108|chr3	CCDS2689.1|Hs108|chr3	0	67	100	67	0	-3	-2
CCDS68391.1|Hs108|chr3	CCDS2689.1|Hs108|chr3	1.73e-19	67	100	67	0	2	3
CCDS68391.1|Hs108|chr3	CCDS2689.1|Hs108|chr3	2.2e-14	67	100	67	0	-2	-1
CCDS69060.1|Hs108|chr6	CCDS4567.1|Hs108|chr6	0	76	100	76	0	-1	-2
CCDS69159.1|Hs108|chr6	CCDS75498.1|Hs108|chr6	7.56e-33	56	100	56	0	2	1
CCDS69159.1|Hs108|chr6	CCDS75498.1|Hs108|chr6	2.69e-32	56	100	56	0	-1	-2
CCDS69490.1|Hs108|chr8	CCDS6181.1|Hs108|chr8	1.86e-115	54	98.148	53	1	1	3
CCDS69668.1|Hs108|chr9	CCDS69669.1|Hs108|chr9	0	68	94.118	64	4	1	3
CCDS69669.1|Hs108|chr9	CCDS6882.1|Hs108|chr9	0	56	100	56	0	3	1
CCDS69669.1|Hs108|chr9	CCDS69668.1|Hs108|chr9	0	56	100	56	0	3	1
CCDS72686.1|Hs108|chr1	CCDS72687.1|Hs108|chr1	1.14e-66	97	100	97	0	3	1
CCDS72686.1|Hs108|chr1	CCDS38.2|Hs108|chr1	6.56e-56	83	100	83	0	3	1
CCDS72687.1|Hs108|chr1	CCDS72686.1|Hs108|chr1	9.92e-75	107	99.065	106	1	1	3
CCDS72796.1|Hs108|chr1	CCDS574.1|Hs108|chr1	0	51	100	51	0	-1	-2
CCDS72796.1|Hs108|chr1	CCDS574.1|Hs108|chr1	0	51	100	51	0	-3	-1
CCDS72796.1|Hs108|chr1	CCDS72797.1|Hs108|chr1	0	51	100	51	0	-1	-2
CCDS72796.1|Hs108|chr1	CCDS72797.1|Hs108|chr1	0	51	100	51	0	-3	-1
CCDS72797.1|Hs108|chr1	CCDS72796.1|Hs108|chr1	0	51	100	51	0	-1	-3
CCDS72920.1|Hs108|chr1	CCDS1055.1|Hs108|chr1	3.77e-66	55	100	55	0	-1	-2
CCDS72946.1|Hs108|chr1	CCDS1135.1|Hs108|chr1	1.06e-171	71	98.592	70	1	3	1
CCDS72946.1|Hs108|chr1	CCDS1135.1|Hs108|chr1	5.14e-164	71	98.592	70	1	-3	-2
CCDS72949.1|Hs108|chr1	CCDS1139.1|Hs108|chr1	0	55	100	55	0	-1	-2
CCDS72949.1|Hs108|chr1	CCDS1139.1|Hs108|chr1	0	55	100	55	0	1	3
CCDS72949.1|Hs108|chr1	CCDS72948.1|Hs108|chr1	8.6e-164	55	100	55	0	-1	-2
CCDS72949.1|Hs108|chr1	CCDS72948.1|Hs108|chr1	5.22e-131	55	100	55	0	1	3
CCDS72962.1|Hs108|chr1	CCDS72963.1|Hs108|chr1	1.09e-137	74	97.297	72	2	1	2
CCDS72963.1|Hs108|chr1	CCDS30927.1|Hs108|chr1	0	131	98.473	129	2	-1	-3
CCDS72964.1|Hs108|chr1	CCDS72965.1|Hs108|chr1	6.04e-132	74	97.297	72	2	1	2
CCDS72965.1|Hs108|chr1	CCDS30927.1|Hs108|chr1	0	131	98.473	129	2	-1	-3
CCDS73012.1|Hs108|chr1	CCDS73013.1|Hs108|chr1	1.68e-53	99	91.919	91	8	-3	-2
CCDS73013.1|Hs108|chr1	CCDS73012.1|Hs108|chr1	1.86e-53	99	91.919	91	8	-2	-3
CCDS73021.1|Hs108|chr1	CCDS53466.1|Hs108|chr1	1.91e-28	59	88.136	52	7	-3	-2
CCDS73021.1|Hs108|chr1	CCDS53466.1|Hs108|chr1	4.09e-19	59	88.136	52	7	3	1
CCDS73095.1|Hs108|chr10	CCDS73096.1|Hs108|chr10	2.1e-23	53	81.132	43	10	2	3
CCDS73096.1|Hs108|chr10	CCDS73095.1|Hs108|chr10	4.19e-23	53	81.132	43	10	3	2
CCDS73269.1|Hs108|chr11	CCDS44559.1|Hs108|chr11	0	84	97.619	82	2	-2	-3
CCDS73269.1|Hs108|chr11	CCDS31450.1|Hs108|chr11	1.06e-165	52	90.385	47	5	-2	-3
CCDS73271.1|Hs108|chr11	CCDS73272.1|Hs108|chr11	0	64	92.188	59	5	1	2
CCDS73272.1|Hs108|chr11	CCDS73271.1|Hs108|chr11	0	64	92.188	59	5	2	1
CCDS73306.1|Hs108|chr11	CCDS8028.1|Hs108|chr11	1.77e-55	85	100	85	0	3	1
CCDS73316.1|Hs108|chr11	CCDS31603.1|Hs108|chr11	5.27e-88	59	100	59	0	-2	-3
CCDS73316.1|Hs108|chr11	CCDS31603.1|Hs108|chr11	2.07e-82	59	100	59	0	2	1
CCDS73316.1|Hs108|chr11	CCDS31603.1|Hs108|chr11	3.31e-62	59	100	59	0	-3	-1
CCDS73326.1|Hs108|chr11	CCDS8137.1|Hs108|chr11	1.57e-149	87	100	87	0	-3	-1
CCDS73347.1|Hs108|chr11	CCDS8230.1|Hs108|chr11	0	55	96.364	53	2	1	2
CCDS73431.1|Hs108|chr12	CCDS8573.1|Hs108|chr12	0	96	98.958	95	1	-3	-2
CCDS73431.1|Hs108|chr12	CCDS8573.1|Hs108|chr12	1.16e-177	96	98.958	95	1	3	1
CCDS73752.1|Hs108|chr15	CCDS55972.1|Hs108|chr15	0	54	94.444	51	3	-3	-1
CCDS73921.1|Hs108|chr16	CCDS58491.1|Hs108|chr16	7.91e-59	50	98	49	1	1	2
CCDS73925.1|Hs108|chr16	CCDS45547.2|Hs108|chr16	4.68e-27	62	98.387	61	1	2	3
CCDS74151.1|Hs108|chr17	CCDS11704.1|Hs108|chr17	3.09e-146	84	98.81	83	1	-1	-2
CCDS74151.1|Hs108|chr17	CCDS74149.1|Hs108|chr17	2.39e-143	84	98.81	83	1	-1	-2
CCDS74176.1|Hs108|chr17	CCDS11786.1|Hs108|chr17	4.81e-174	84	100	84	0	-3	-1
CCDS74176.1|Hs108|chr17	CCDS11786.1|Hs108|chr17	5.86e-147	84	100	84	0	-1	-2
CCDS74176.1|Hs108|chr17	CCDS11786.1|Hs108|chr17	4.4e-141	84	100	84	0	2	1
CCDS74176.1|Hs108|chr17	CCDS59301.1|Hs108|chr17	2.96e-143	82	96.341	79	3	-3	-1
CCDS74180.1|Hs108|chr17	CCDS11789.1|Hs108|chr17	9.28e-48	51	100	51	0	2	1
CCDS74180.1|Hs108|chr17	CCDS11789.1|Hs108|chr17	5.06e-45	51	100	51	0	-1	-2
CCDS74199.1|Hs108|chr18	CCDS82243.1|Hs108|chr18	0	56	98.214	55	1	-1	-3
CCDS74199.1|Hs108|chr18	CCDS32803.1|Hs108|chr18	0	56	98.214	55	1	-1	-3
CCDS74241.1|Hs108|chr19	CCDS12037.1|Hs108|chr19	1.11e-82	58	100	58	0	2	1
CCDS74271.1|Hs108|chr19	CCDS74272.1|Hs108|chr19	0	55	90.909	50	5	2	1
CCDS74272.1|Hs108|chr19	CCDS12172.1|Hs108|chr19	0	50	100	50	0	-2	-1
CCDS74272.1|Hs108|chr19	CCDS12172.1|Hs108|chr19	0	50	100	50	0	2	3
CCDS74272.1|Hs108|chr19	CCDS12172.1|Hs108|chr19	0	50	100	50	0	3	1
CCDS74272.1|Hs108|chr19	CCDS12172.1|Hs108|chr19	0	50	100	50	0	-1	-3
CCDS74272.1|Hs108|chr19	CCDS12172.1|Hs108|chr19	0	50	100	50	0	-3	-2
CCDS74272.1|Hs108|chr19	CCDS74271.1|Hs108|chr19	0	50	100	50	0	-2	-1
CCDS74272.1|Hs108|chr19	CCDS74271.1|Hs108|chr19	0	50	100	50	0	2	3
CCDS74272.1|Hs108|chr19	CCDS74271.1|Hs108|chr19	0	50	100	50	0	3	1
CCDS74272.1|Hs108|chr19	CCDS74271.1|Hs108|chr19	0	50	100	50	0	-1	-3
CCDS74272.1|Hs108|chr19	CCDS74271.1|Hs108|chr19	0	50	100	50	0	-3	-2
CCDS74541.1|Hs108|chr2	CCDS74542.1|Hs108|chr2	7.05e-68	63	100	63	0	-2	-3
CCDS74541.1|Hs108|chr2	CCDS74542.1|Hs108|chr2	6.09e-63	63	100	63	0	1	3
CCDS74541.1|Hs108|chr2	CCDS74542.1|Hs108|chr2	2.69e-61	63	100	63	0	-1	-2
CCDS74541.1|Hs108|chr2	CCDS74542.1|Hs108|chr2	9.01e-44	63	100	63	0	-3	-1
CCDS74542.1|Hs108|chr2	CCDS74541.1|Hs108|chr2	3.07e-66	63	100	63	0	-3	-2
CCDS74542.1|Hs108|chr2	CCDS74541.1|Hs108|chr2	1.54e-62	63	100	63	0	3	1
CCDS74542.1|Hs108|chr2	CCDS74541.1|Hs108|chr2	1.76e-60	63	100	63	0	-2	-1
CCDS74542.1|Hs108|chr2	CCDS74541.1|Hs108|chr2	2.29e-43	63	100	63	0	-1	-3
CCDS74574.1|Hs108|chr2	CCDS2162.1|Hs108|chr2	7.11e-108	63	100	63	0	-3	-2
CCDS74574.1|Hs108|chr2	CCDS33286.1|Hs108|chr2	8.85e-107	63	100	63	0	-3	-2
CCDS74577.1|Hs108|chr2	CCDS46413.1|Hs108|chr2	2.28e-111	74	100	74	0	-1	-3
CCDS74577.1|Hs108|chr2	CCDS46413.1|Hs108|chr2	6.25e-108	74	100	74	0	1	2
CCDS74577.1|Hs108|chr2	CCDS46413.1|Hs108|chr2	1.84e-94	74	100	74	0	-2	-1
CCDS74577.1|Hs108|chr2	CCDS58730.1|Hs108|chr2	1.4e-94	77	96.104	74	3	-2	-1
CCDS74750.1|Hs108|chr20	CCDS13524.1|Hs108|chr20	2.79e-78	61	96.721	59	2	-1	-2
CCDS74796.1|Hs108|chr21	CCDS13673.1|Hs108|chr21	0	91	86.813	79	12	1	3
CCDS74812.1|Hs108|chr22	CCDS13746.1|Hs108|chr22	1.35e-80	53	100	53	0	3	2
CCDS74812.1|Hs108|chr22	CCDS13746.1|Hs108|chr22	9.37e-77	53	100	53	0	1	3
CCDS74812.1|Hs108|chr22	CCDS13746.1|Hs108|chr22	7.91e-61	53	100	53	0	-3	-1
CCDS74812.1|Hs108|chr22	CCDS13746.1|Hs108|chr22	1.26e-52	53	100	53	0	-1	-2
CCDS74814.1|Hs108|chr22	CCDS13746.1|Hs108|chr22	7.25e-39	54	100	54	0	-1	-2
CCDS74828.1|Hs108|chr22	CCDS13818.1|Hs108|chr22	0	67	100	67	0	-2	-1
CCDS74828.1|Hs108|chr22	CCDS13818.1|Hs108|chr22	0	67	100	67	0	2	3
CCDS74828.1|Hs108|chr22	CCDS46673.1|Hs108|chr22	0	67	100	67	0	-2	-1
CCDS74828.1|Hs108|chr22	CCDS46673.1|Hs108|chr22	0	67	100	67	0	2	3
CCDS74954.1|Hs108|chr3	CCDS2889.1|Hs108|chr3	0	62	100	62	0	1	3
CCDS74954.1|Hs108|chr3	CCDS2889.1|Hs108|chr3	0	62	100	62	0	-2	-3
CCDS75142.1|Hs108|chr4	CCDS56334.1|Hs108|chr4	8.46e-27	50	96	48	2	-2	-3
CCDS75173.1|Hs108|chr4	CCDS75174.1|Hs108|chr4	0	57	100	57	0	1	3
CCDS75173.1|Hs108|chr4	CCDS75174.1|Hs108|chr4	0	57	100	57	0	3	2
CCDS75173.1|Hs108|chr4	CCDS75174.1|Hs108|chr4	0	57	100	57	0	-3	-1
CCDS75173.1|Hs108|chr4	CCDS75174.1|Hs108|chr4	0	57	100	57	0	-2	-3
CCDS75173.1|Hs108|chr4	CCDS75174.1|Hs108|chr4	0	57	100	57	0	-1	-2
CCDS75173.1|Hs108|chr4	CCDS3662.1|Hs108|chr4	0	57	100	57	0	1	3
CCDS75173.1|Hs108|chr4	CCDS3662.1|Hs108|chr4	0	57	100	57	0	3	2
CCDS75173.1|Hs108|chr4	CCDS3662.1|Hs108|chr4	0	57	100	57	0	-3	-1
CCDS75173.1|Hs108|chr4	CCDS3662.1|Hs108|chr4	0	57	100	57	0	-2	-3
CCDS75173.1|Hs108|chr4	CCDS3662.1|Hs108|chr4	0	57	100	57	0	-1	-2
CCDS75174.1|Hs108|chr4	CCDS75173.1|Hs108|chr4	0	57	100	57	0	3	1
CCDS75174.1|Hs108|chr4	CCDS75173.1|Hs108|chr4	0	57	100	57	0	-3	-2
CCDS75232.1|Hs108|chr5	CCDS43308.1|Hs108|chr5	2.37e-151	59	96.61	57	2	2	1
CCDS75232.1|Hs108|chr5	CCDS3901.1|Hs108|chr5	2.75e-151	59	96.61	57	2	2	1
CCDS75468.1|Hs108|chr6	CCDS4940.2|Hs108|chr6	0	74	95.946	71	3	3	1
CCDS75470.1|Hs108|chr6	CCDS4951.1|Hs108|chr6	1.22e-175	93	100	93	0	2	1
CCDS75470.1|Hs108|chr6	CCDS4951.1|Hs108|chr6	1.09e-171	93	100	93	0	-3	-1
CCDS75470.1|Hs108|chr6	CCDS56433.1|Hs108|chr6	6.72e-175	93	100	93	0	2	1
CCDS75470.1|Hs108|chr6	CCDS56433.1|Hs108|chr6	2.44e-169	93	100	93	0	-3	-1
CCDS75498.1|Hs108|chr6	CCDS5055.1|Hs108|chr6	4e-55	56	100	56	0	-2	-1
CCDS75498.1|Hs108|chr6	CCDS5055.1|Hs108|chr6	2.41e-53	56	100	56	0	1	2
CCDS75498.1|Hs108|chr6	CCDS5055.1|Hs108|chr6	7.04e-51	56	100	56	0	-1	-3
CCDS75498.1|Hs108|chr6	CCDS69159.1|Hs108|chr6	2.43e-33	56	100	56	0	1	2
CCDS75498.1|Hs108|chr6	CCDS69159.1|Hs108|chr6	8.68e-33	56	100	56	0	-2	-1
CCDS75498.1|Hs108|chr6	CCDS69159.1|Hs108|chr6	2.08e-31	56	100	56	0	-1	-3
CCDS75631.1|Hs108|chr7	CCDS5629.1|Hs108|chr7	0	76	100	76	0	-2	-1
CCDS75631.1|Hs108|chr7	CCDS5629.1|Hs108|chr7	0	76	100	76	0	-3	-2
CCDS75631.1|Hs108|chr7	CCDS5629.1|Hs108|chr7	0	76	100	76	0	3	1
CCDS75631.1|Hs108|chr7	CCDS75632.1|Hs108|chr7	0	76	100	76	0	-2	-1
CCDS75631.1|Hs108|chr7	CCDS75632.1|Hs108|chr7	0	76	100	76	0	-3	-2
CCDS75631.1|Hs108|chr7	CCDS75632.1|Hs108|chr7	0	76	100	76	0	3	1
CCDS75643.1|Hs108|chr7	CCDS5714.1|Hs108|chr7	4.05e-126	66	81.818	54	12	-3	-1
CCDS75669.1|Hs108|chr7	CCDS5858.1|Hs108|chr7	0	54	100	54	0	-1	-3
CCDS75680.1|Hs108|chr7	CCDS64806.1|Hs108|chr7	1.5e-167	141	97.163	137	4	-1	-3
CCDS75974.1|Hs108|chrX	CCDS75973.1|Hs108|chrX	1.08e-77	52	98.077	51	1	2	1
CCDS75974.1|Hs108|chrX	CCDS65254.1|Hs108|chrX	1.12e-77	52	98.077	51	1	2	1
CCDS75987.1|Hs108|chrX	CCDS14356.1|Hs108|chrX	6.65e-46	90	97.778	88	2	1	2
CCDS75995.1|Hs108|chrX	CCDS14432.1|Hs108|chrX	1.47e-82	71	100	71	0	3	1
CCDS76039.1|Hs108|chrX	CCDS55518.1|Hs108|chrX	0	80	100	80	0	-1	-2
CCDS76284.1|Hs108|chr10	CCDS7109.1|Hs108|chr10	3.46e-22	65	87.692	57	8	-1	-3
CCDS76395.1|Hs108|chr11	CCDS7900.1|Hs108|chr11	4.11e-106	82	97.561	80	2	2	1
CCDS76395.1|Hs108|chr11	CCDS44571.1|Hs108|chr11	1.31e-76	82	97.561	80	2	2	1
CCDS76407.1|Hs108|chr11	CCDS53635.1|Hs108|chr11	0	53	100	53	0	1	2
CCDS76407.1|Hs108|chr11	CCDS7969.1|Hs108|chr11	0	53	100	53	0	1	2
CCDS76415.1|Hs108|chr11	CCDS8023.2|Hs108|chr11	0	63	100	63	0	1	3
CCDS76609.1|Hs108|chr12	CCDS9206.1|Hs108|chr12	2.77e-39	90	86.667	78	12	3	1
CCDS76691.1|Hs108|chr14	CCDS9768.1|Hs108|chr14	2.11e-107	61	95.082	58	3	-2	-3
CCDS76855.1|Hs108|chr16	CCDS76856.1|Hs108|chr16	1.99e-84	68	100	68	0	3	1
CCDS76855.1|Hs108|chr16	CCDS76856.1|Hs108|chr16	2.71e-80	68	100	68	0	-2	-1
CCDS76855.1|Hs108|chr16	CCDS76856.1|Hs108|chr16	8.36e-75	68	100	68	0	2	3
CCDS76855.1|Hs108|chr16	CCDS76856.1|Hs108|chr16	1.03e-40	68	100	68	0	1	2
CCDS76876.1|Hs108|chr16	CCDS76877.1|Hs108|chr16	2.13e-165	58	98.276	57	1	3	1
CCDS76877.1|Hs108|chr16	CCDS10781.2|Hs108|chr16	6.71e-174	58	98.276	57	1	1	3
CCDS76877.1|Hs108|chr16	CCDS76876.1|Hs108|chr16	1.39e-165	58	98.276	57	1	1	3
CCDS77397.1|Hs108|chr2	CCDS1744.1|Hs108|chr2	6.26e-49	65	100	65	0	2	3
CCDS77667.1|Hs108|chr22	CCDS13883.1|Hs108|chr22	4.54e-75	64	100	64	0	-1	-2
CCDS77667.1|Hs108|chr22	CCDS14264.1|Hs108|chrX	1.28e-48	63	84.127	53	10	2	1
CCDS77682.1|Hs108|chr22	CCDS77683.1|Hs108|chr22	1.15e-60	58	96.552	56	2	2	3
CCDS77683.1|Hs108|chr22	CCDS14025.1|Hs108|chr22	7.61e-59	58	96.552	56	2	3	2
CCDS77683.1|Hs108|chr22	CCDS77682.1|Hs108|chr22	7.62e-59	58	96.552	56	2	3	2
CCDS77733.1|Hs108|chr3	CCDS2763.1|Hs108|chr3	6.96e-110	101	99.01	100	1	-1	-3
CCDS77733.1|Hs108|chr3	CCDS77734.1|Hs108|chr3	6.96e-110	101	99.01	100	1	-1	-3
CCDS77734.1|Hs108|chr3	CCDS77733.1|Hs108|chr3	8.31e-110	101	99.01	100	1	-3	-1
CCDS77867.1|Hs108|chr3	CCDS3265.1|Hs108|chr3	3.31e-159	129	100	129	0	-1	-2
CCDS77867.1|Hs108|chr3	CCDS54693.1|Hs108|chr3	1.34e-150	129	100	129	0	-1	-2
CCDS77887.1|Hs108|chr4	CCDS33937.1|Hs108|chr4	0	82	97.561	80	2	-1	-2
CCDS77887.1|Hs108|chr4	CCDS33936.1|Hs108|chr4	0	82	97.561	80	2	-1	-2
CCDS78455.1|Hs108|chr9	CCDS78456.1|Hs108|chr9	1.9e-87	129	96.899	125	4	2	3
CCDS78456.1|Hs108|chr9	CCDS78455.1|Hs108|chr9	9.05e-102	124	100	124	0	2	1
CCDS78456.1|Hs108|chr9	CCDS78455.1|Hs108|chr9	1.78e-82	124	100	124	0	1	3
CCDS78456.1|Hs108|chr9	CCDS6992.1|Hs108|chr9	6.57e-80	65	95.385	62	3	2	1
CCDS81261.1|Hs108|chr1	CCDS132.1|Hs108|chr1	2.98e-142	125	100	125	0	-3	-1
CCDS81261.1|Hs108|chr1	CCDS132.1|Hs108|chr1	1.17e-109	125	100	125	0	-1	-2
CCDS81389.1|Hs108|chr1	CCDS1207.1|Hs108|chr1	0	72	94.444	68	4	3	1
CCDS81517.1|Hs108|chr10	CCDS7629.1|Hs108|chr10	0	78	91.026	71	7	2	3
CCDS81812.1|Hs108|chr14	CCDS9768.1|Hs108|chr14	7.44e-75	61	95.082	58	3	-2	-3
CCDS81830.1|Hs108|chr14	CCDS9867.1|Hs108|chr14	0	66	100	66	0	-1	-3
CCDS81830.1|Hs108|chr14	CCDS9867.1|Hs108|chr14	0	66	100	66	0	1	2
CCDS81830.1|Hs108|chr14	CCDS9867.1|Hs108|chr14	0	66	100	66	0	2	3
CCDS81938.1|Hs108|chr16	CCDS81939.1|Hs108|chr16	3.39e-114	57	100	57	0	-1	-3
CCDS81938.1|Hs108|chr16	CCDS45396.1|Hs108|chr16	5.43e-113	55	96.364	53	2	-2	-3
CCDS81939.1|Hs108|chr16	CCDS81938.1|Hs108|chr16	3.13e-114	57	100	57	0	-3	-1
CCDS81940.1|Hs108|chr16	CCDS81938.1|Hs108|chr16	5.52e-82	63	90.476	57	6	-2	-1
CCDS81968.1|Hs108|chr16	CCDS45443.1|Hs108|chr16	0	262	97.328	255	7	1	3
CCDS82085.1|Hs108|chr17	CCDS11202.1|Hs108|chr17	8.22e-106	63	98.413	62	1	3	1
CCDS82096.1|Hs108|chr17	CCDS54101.1|Hs108|chr17	1.04e-36	62	96.774	60	2	-3	-1
CCDS82096.1|Hs108|chr17	CCDS58536.1|Hs108|chr17	7.56e-29	51	96.078	49	2	-1	-2
CCDS82207.1|Hs108|chr17	CCDS45626.1|Hs108|chr17	1.89e-163	91	85.714	78	13	3	1
CCDS82231.1|Hs108|chr17	CCDS42402.1|Hs108|chr17	0	134	100	134	0	-1	-2
CCDS82231.1|Hs108|chr17	CCDS42402.1|Hs108|chr17	0	134	100	134	0	1	3
CCDS82243.1|Hs108|chr18	CCDS74199.1|Hs108|chr18	0	56	98.214	55	1	-3	-1
CCDS82371.1|Hs108|chr19	CCDS12694.1|Hs108|chr19	2.42e-124	55	100	55	0	-1	-2
CCDS82429.1|Hs108|chr2	CCDS42661.1|Hs108|chr2	1.51e-118	173	100	173	0	-1	-2
CCDS82588.1|Hs108|chr20	CCDS13000.2|Hs108|chr20	5.35e-175	103	100	103	0	-2	-1
CCDS82588.1|Hs108|chr20	CCDS12998.1|Hs108|chr20	4.49e-175	103	100	103	0	-2	-1
CCDS82600.1|Hs108|chr20	CCDS13131.1|Hs108|chr20	4.61e-150	60	96.667	58	2	2	1
CCDS82619.1|Hs108|chr20	CCDS13336.1|Hs108|chr20	7.58e-84	82	93.902	77	5	2	3
CCDS82619.1|Hs108|chr20	CCDS13336.1|Hs108|chr20	6.62e-79	82	93.902	77	5	-1	-3
CCDS82638.1|Hs108|chr20	CCDS13536.1|Hs108|chr20	4.23e-114	118	100	118	0	3	2
CCDS82698.1|Hs108|chr22	CCDS13814.2|Hs108|chr22	2.89e-90	69	95.652	66	3	2	3
CCDS82837.1|Hs108|chr3	CCDS54639.1|Hs108|chr3	0	60	100	60	0	-3	-1
