query	subject	evalue	alnlength	identity	identical	mismatches	qframe	sframe
ENSG00000006451	ENSG00000144118	1.07e-71	126	89.683	113	13	3	1
ENSG00000144118	ENSG00000006451	1.34e-69	126	89.683	113	13	1	3
ENSG00000004975	ENSG00000161202	0	131	91.603	120	11	2	3
ENSG00000161202	ENSG00000004975	0	131	91.603	120	11	3	2
ENSG00000006116	ENSG00000166862	5.47e-132	175	84.571	148	27	3	2
ENSG00000166862	ENSG00000006116	9.66e-130	167	86.228	144	23	2	3
ENSG00000015568	ENSG00000183054	0	946	100	946	0	-3	-2
ENSG00000183054	ENSG00000015568	0	946	100	946	0	-2	-3
ENSG00000088256	ENSG00000156052	0	360	90.278	325	35	3	2
ENSG00000156052	ENSG00000088256	0	315	91.111	287	28	2	3
ENSG00000050327	ENSG00000213214	0	389	99.486	387	2	2	3
ENSG00000213214	ENSG00000050327	0	389	99.486	387	2	3	2
ENSG00000019549	ENSG00000124216	4.92e-73	113	85.841	97	16	3	2
ENSG00000124216	ENSG00000019549	1.92e-75	113	85.841	97	16	2	3
ENSG00000186847	ENSG00000128422	0	312	89.423	279	33	1	3
ENSG00000128422	ENSG00000186847	0	320	88.75	284	36	3	1
ENSG00000068976	ENSG00000100994	0	833	84.154	701	132	1	3
ENSG00000100994	ENSG00000068976	0	697	83.07	579	118	3	1
ENSG00000083720	ENSG00000198754	0	221	80.543	178	43	3	1
ENSG00000198754	ENSG00000083720	0	218	81.193	177	41	1	3
ENSG00000197208	ENSG00000197375	0	322	86.025	277	45	1	3
ENSG00000197375	ENSG00000197208	0	322	86.025	277	45	3	1
ENSG00000100490	ENSG00000125375	2.67e-175	258	99.225	256	2	1	-2
ENSG00000125375	ENSG00000100490	0	260	100	260	0	2	-1
ENSG00000101162	ENSG00000124172	0	395	100	395	0	-3	2
ENSG00000124172	ENSG00000101162	0	395	100	395	0	-2	3
ENSG00000124172	ENSG00000101162	0	395	100	395	0	2	-3
ENSG00000099804	ENSG00000107341	8.22e-122	198	86.869	172	26	2	3
ENSG00000107341	ENSG00000099804	5.82e-120	196	86.735	170	26	3	2
ENSG00000083812	ENSG00000249471	0	516	90.891	469	47	2	3
ENSG00000249471	ENSG00000083812	0	333	93.093	310	23	3	2
ENSG00000087303	ENSG00000087302	0	236	98.729	233	3	3	-1
ENSG00000087302	ENSG00000087303	0	236	98.729	233	3	-1	3
ENSG00000095917	ENSG00000172236	0	282	85.106	240	42	2	1
ENSG00000172236	ENSG00000095917	0	294	85.374	251	43	1	2
ENSG00000099974	ENSG00000099977	4.27e-61	104	96.154	100	4	-3	-2
ENSG00000099977	ENSG00000099974	1.61e-61	104	96.154	100	4	-2	-3
ENSG00000100450	ENSG00000100453	4.38e-108	129	86.047	111	18	1	3
ENSG00000100453	ENSG00000100450	7.72e-110	152	84.211	128	24	3	1
ENSG00000100564	ENSG00000054690	3.88e-65	100	100	100	0	2	-3
ENSG00000100564	ENSG00000054690	1.5e-61	100	100	100	0	3	-1
ENSG00000100564	ENSG00000054690	2.06e-61	100	100	100	0	-1	3
ENSG00000100564	ENSG00000054690	1.01e-60	100	100	100	0	-2	1
ENSG00000100564	ENSG00000054690	3.59e-60	100	100	100	0	1	-2
ENSG00000100564	ENSG00000054690	9.3e-56	100	100	100	0	-3	2
ENSG00000054690	ENSG00000100564	1.96e-64	100	100	100	0	-3	2
ENSG00000054690	ENSG00000100564	4.7e-55	100	100	100	0	2	-3
ENSG00000054690	ENSG00000100564	7.56e-61	100	100	100	0	-1	3
ENSG00000054690	ENSG00000100564	1.04e-60	100	100	100	0	3	-1
ENSG00000054690	ENSG00000100564	5.09e-60	100	100	100	0	1	-2
ENSG00000054690	ENSG00000100564	1.81e-59	100	100	100	0	-2	1
ENSG00000100314	ENSG00000100319	5.87e-83	139	97.122	135	4	-1	1
ENSG00000100319	ENSG00000100314	1.42e-83	139	97.122	135	4	1	-1
ENSG00000101405	ENSG00000101200	2.33e-54	107	80.374	86	21	-2	-1
ENSG00000101200	ENSG00000101405	2.95e-54	107	80.374	86	21	-1	-2
ENSG00000090581	ENSG00000059145	0	302	100	302	0	2	-2
ENSG00000090581	ENSG00000059145	6.01e-178	302	100	302	0	3	-3
ENSG00000059145	ENSG00000090581	0	302	100	302	0	-2	2
ENSG00000059145	ENSG00000090581	1.36e-177	302	100	302	0	-3	3
ENSG00000086232	ENSG00000106305	7.52e-106	178	100	178	0	2	-1
ENSG00000106305	ENSG00000086232	1.88e-106	178	100	178	0	-1	2
ENSG00000092607	ENSG00000112837	7.74e-157	234	85.47	200	34	1	3
ENSG00000092607	ENSG00000112837	2.23e-157	234	85.47	200	34	2	3
ENSG00000112837	ENSG00000092607	1.48e-156	252	80.952	204	48	3	1
ENSG00000112837	ENSG00000092607	6.33e-159	252	80.952	204	48	3	2
ENSG00000243811	ENSG00000128394	0	246	88.211	217	29	3	1
ENSG00000128394	ENSG00000243811	0	360	83.889	302	58	1	3
ENSG00000100030	ENSG00000102882	0	346	88.15	305	41	1	2
ENSG00000102882	ENSG00000100030	0	345	88.116	304	41	2	1
ENSG00000109061	ENSG00000264424	0	630	95.873	604	26	3	1
ENSG00000264424	ENSG00000109061	0	862	95.592	824	38	1	3
ENSG00000016082	ENSG00000159556	0	188	81.383	153	35	3	2
ENSG00000159556	ENSG00000016082	2.71e-174	188	81.383	153	35	2	3
ENSG00000105664	ENSG00000113296	0	271	87.823	238	33	1	2
ENSG00000113296	ENSG00000105664	0	277	87.004	241	36	2	1
ENSG00000102128	ENSG00000172476	0	254	98.031	249	5	3	2
ENSG00000102128	ENSG00000172476	0	254	98.031	249	5	3	1
ENSG00000172476	ENSG00000102128	0	242	98.347	238	4	2	3
ENSG00000172476	ENSG00000102128	0	242	98.347	238	4	1	3
ENSG00000105649	ENSG00000152932	1.68e-123	194	88.66	172	22	3	2
ENSG00000152932	ENSG00000105649	3.65e-118	194	88.66	172	22	2	3
ENSG00000104863	ENSG00000148943	2.56e-101	204	82.353	168	36	3	1
ENSG00000148943	ENSG00000104863	1.89e-100	204	82.353	168	36	1	3
ENSG00000104129	ENSG00000137880	9.5e-128	161	100	161	0	-2	2
ENSG00000104129	ENSG00000137880	1.24e-121	161	100	161	0	3	-1
ENSG00000104129	ENSG00000137880	2.08e-116	161	100	161	0	-1	1
ENSG00000137880	ENSG00000104129	6.83e-129	161	100	161	0	2	-2
ENSG00000137880	ENSG00000104129	1.98e-122	161	100	161	0	-1	3
ENSG00000137880	ENSG00000104129	1.61e-116	161	100	161	0	1	-1
ENSG00000108773	ENSG00000114166	0	239	83.682	200	39	1	3
ENSG00000114166	ENSG00000108773	0	252	81.349	205	47	3	1
ENSG00000104888	ENSG00000091664	0	512	82.422	422	90	2	3
ENSG00000091664	ENSG00000104888	0	512	82.422	422	90	3	2
ENSG00000105254	ENSG00000105258	2.94e-77	120	100	120	0	1	-1
ENSG00000105254	ENSG00000105258	1.33e-75	120	100	120	0	-1	2
ENSG00000105258	ENSG00000105254	1.7e-77	120	100	120	0	-1	1
ENSG00000105258	ENSG00000105254	7.7e-76	120	100	120	0	2	-1
ENSG00000114853	ENSG00000198740	0	260	91.538	238	22	3	2
ENSG00000198740	ENSG00000114853	1.82e-176	245	93.878	230	15	2	3
ENSG00000108379	ENSG00000154342	0	347	85.014	295	52	2	1
ENSG00000154342	ENSG00000108379	0	344	85.465	294	50	1	2
ENSG00000108590	ENSG00000129235	0	408	100	408	0	3	-2
ENSG00000129235	ENSG00000108590	0	408	100	408	0	2	-3
ENSG00000129235	ENSG00000108590	0	408	100	408	0	-2	3
ENSG00000111615	ENSG00000139278	0	379	99.736	378	1	-2	2
ENSG00000139278	ENSG00000111615	0	379	99.736	378	1	2	-2
ENSG00000039123	ENSG00000067113	1.23e-100	160	100	160	0	1	-2
ENSG00000039123	ENSG00000067113	6e-100	160	100	160	0	-2	2
ENSG00000039123	ENSG00000067113	5.55e-99	160	100	160	0	-3	3
ENSG00000067113	ENSG00000039123	4.27e-101	160	100	160	0	-2	1
ENSG00000067113	ENSG00000039123	2.09e-100	160	100	160	0	2	-2
ENSG00000067113	ENSG00000039123	1.93e-99	160	100	160	0	3	-3
ENSG00000108417	ENSG00000171360	0	252	87.302	220	32	-1	-2
ENSG00000171360	ENSG00000108417	2.17e-169	159	90.566	144	15	-2	-1
ENSG00000114349	ENSG00000134183	0	326	83.129	271	55	1	2
ENSG00000134183	ENSG00000114349	0	344	82.558	284	60	2	1
ENSG00000103064	ENSG00000103061	0	977	100	977	0	-3	2
ENSG00000103061	ENSG00000103064	0	977	100	977	0	2	-3
ENSG00000112309	ENSG00000112305	0	519	100	519	0	3	-2
ENSG00000112305	ENSG00000112309	0	519	100	519	0	-2	3
ENSG00000107018	ENSG00000107014	5.52e-139	260	83.462	217	43	-3	-2
ENSG00000107014	ENSG00000107018	6.3e-149	260	84.231	219	41	3	2
ENSG00000123908	ENSG00000092847	0	838	83.652	701	137	3	1
ENSG00000092847	ENSG00000123908	0	856	82.477	706	150	1	3
ENSG00000132207	ENSG00000181625	0	244	100	244	0	2	1
ENSG00000181625	ENSG00000132207	0	244	100	244	0	1	2
ENSG00000254245	ENSG00000081853	0	412	100	412	0	3	2
ENSG00000081853	ENSG00000254245	0	412	100	412	0	2	3
ENSG00000121068	ENSG00000135111	4.79e-169	239	87.448	209	30	3	2
ENSG00000135111	ENSG00000121068	1.35e-168	239	87.448	209	30	2	3
ENSG00000130449	ENSG00000162415	0	532	80.263	427	105	1	3
ENSG00000162415	ENSG00000130449	0	193	86.01	166	27	3	1
ENSG00000282608	ENSG00000121933	9.93e-121	163	100	163	0	1	2
ENSG00000121933	ENSG00000282608	2.39e-98	164	98.78	162	2	-2	-1
ENSG00000123143	ENSG00000065243	0	331	80.363	266	65	2	3
ENSG00000065243	ENSG00000123143	0	332	80.422	267	65	3	2
ENSG00000120324	ENSG00000177839	0	672	92.411	621	51	3	1
ENSG00000177839	ENSG00000120324	0	669	92.377	618	51	1	3
ENSG00000124140	ENSG00000113504	0	256	89.453	229	27	2	3
ENSG00000113504	ENSG00000124140	0	548	81.204	445	103	3	2
ENSG00000122543	ENSG00000135175	2.3e-153	231	98.268	227	4	-3	-1
ENSG00000135175	ENSG00000122543	2.3e-153	231	98.268	227	4	-1	-3
ENSG00000131094	ENSG00000186897	7.33e-87	134	88.06	118	16	3	1
ENSG00000186897	ENSG00000131094	1.1e-81	134	88.06	118	16	1	3
ENSG00000130733	ENSG00000142453	1.09e-136	245	100	245	0	2	-1
ENSG00000142453	ENSG00000130733	4.97e-138	245	100	245	0	-1	2
ENSG00000115042	ENSG00000144199	0	329	96.657	318	11	-1	-3
ENSG00000144199	ENSG00000115042	0	321	98.131	315	6	3	1
ENSG00000160145	ENSG00000038382	0	182	86.264	157	25	2	1
ENSG00000038382	ENSG00000160145	0	364	85.165	310	54	1	2
ENSG00000131462	ENSG00000037042	0	454	97.577	443	11	3	2
ENSG00000037042	ENSG00000131462	0	465	96.344	448	17	2	3
ENSG00000127780	ENSG00000180016	5.45e-164	192	91.667	176	16	-2	-1
ENSG00000180016	ENSG00000127780	1.8e-162	188	92.021	173	15	-1	-2
ENSG00000115486	ENSG00000168906	3.62e-126	185	100	185	0	3	-3
ENSG00000115486	ENSG00000168906	7.4e-119	185	100	185	0	-3	2
ENSG00000168906	ENSG00000115486	1.3e-126	185	100	185	0	-3	3
ENSG00000168906	ENSG00000115486	2.66e-119	185	100	185	0	2	-3
ENSG00000120329	ENSG00000102743	0	315	86.667	273	42	1	3
ENSG00000102743	ENSG00000120329	0	315	86.667	273	42	3	1
ENSG00000129204	ENSG00000170832	0	779	92.94	724	55	-2	-3
ENSG00000170832	ENSG00000129204	0	784	92.73	727	57	-2	-3
ENSG00000121281	ENSG00000166164	0	725	100	725	0	-2	1
ENSG00000166164	ENSG00000121281	0	726	100	726	0	1	-2
ENSG00000134250	ENSG00000264343	2.59e-159	238	97.479	232	6	3	1
ENSG00000264343	ENSG00000134250	2.86e-171	246	97.561	240	6	1	3
ENSG00000126778	ENSG00000170577	1.59e-128	188	95.213	179	9	1	3
ENSG00000170577	ENSG00000126778	2.17e-121	174	95.977	167	7	3	1
ENSG00000128383	ENSG00000179750	7.76e-173	229	93.886	215	14	3	1
ENSG00000179750	ENSG00000128383	8.34e-173	229	93.886	215	14	1	3
ENSG00000119778	ENSG00000156802	0	335	81.791	274	61	3	1
ENSG00000156802	ENSG00000119778	0	335	81.791	274	61	1	3
ENSG00000058262	ENSG00000065665	0	475	93.684	445	30	2	3
ENSG00000065665	ENSG00000058262	0	477	93.501	446	31	3	2
ENSG00000121297	ENSG00000179981	0	148	85.135	126	22	2	3
ENSG00000179981	ENSG00000121297	0	148	85.135	126	22	3	2
ENSG00000109805	ENSG00000178177	0	474	100	474	0	-2	1
ENSG00000178177	ENSG00000109805	0	474	100	474	0	1	-2
ENSG00000028839	ENSG00000146411	0	463	100	463	0	1	-2
ENSG00000146411	ENSG00000028839	0	463	100	463	0	-2	1
ENSG00000125398	ENSG00000100146	7.06e-129	121	90.909	110	11	1	2
ENSG00000125398	ENSG00000100146	7.33e-129	121	90.909	110	11	1	2
ENSG00000100146	ENSG00000125398	1.02e-127	128	89.062	114	14	2	1
ENSG00000124657	ENSG00000168131	5.33e-171	310	81.613	253	57	1	3
ENSG00000168131	ENSG00000124657	7.12e-171	310	81.613	253	57	3	1
ENSG00000119729	ENSG00000151665	2.05e-143	219	100	219	0	2	-1
ENSG00000151665	ENSG00000119729	8.88e-144	219	100	219	0	-1	2
ENSG00000187545	ENSG00000204479	0	489	86.912	425	64	-3	-2
ENSG00000204479	ENSG00000187545	0	489	86.912	425	64	-2	-3
ENSG00000099822	ENSG00000138622	0	550	90	495	55	3	2
ENSG00000138622	ENSG00000099822	0	562	88.612	498	64	2	3
ENSG00000125966	ENSG00000156103	0	176	85.227	150	26	2	1
ENSG00000156103	ENSG00000125966	0	176	85.227	150	26	1	2
ENSG00000118579	ENSG00000047662	0	1107	100	1107	0	3	-1
ENSG00000047662	ENSG00000118579	0	1107	100	1107	0	-1	3
ENSG00000187272	ENSG00000241595	4.92e-135	172	83.14	143	29	-1	-2
ENSG00000241595	ENSG00000187272	1.53e-75	151	83.444	126	25	-2	-1
ENSG00000128245	ENSG00000170027	4e-142	246	86.992	214	32	1	2
ENSG00000170027	ENSG00000128245	4.92e-135	235	87.66	206	29	2	1
ENSG00000132475	ENSG00000188375	0	129	96.899	125	4	2	1
ENSG00000188375	ENSG00000132475	0	129	96.899	125	4	1	2
ENSG00000119673	ENSG00000184227	0	304	98.355	299	5	-3	-2
ENSG00000184227	ENSG00000119673	0	475	96	456	19	-2	-3
ENSG00000131459	ENSG00000198380	0	446	81.166	362	84	3	1
ENSG00000198380	ENSG00000131459	0	446	81.166	362	84	1	3
ENSG00000115386	ENSG00000172023	2.78e-108	217	81.106	176	41	-2	-1
ENSG00000172023	ENSG00000115386	1.41e-101	217	81.106	176	41	-1	-2
ENSG00000112659	ENSG00000044090	0	210	85.714	180	30	-3	-1
ENSG00000044090	ENSG00000112659	0	223	84.305	188	35	-1	-3
ENSG00000188536	ENSG00000206172	5.22e-112	178	95.506	170	8	1	2
ENSG00000206172	ENSG00000188536	4.91e-112	178	95.506	170	8	2	1
ENSG00000125629	ENSG00000186480	3.09e-110	185	84.324	156	29	3	2
ENSG00000186480	ENSG00000125629	1.29e-89	185	84.324	156	29	2	3
ENSG00000133243	ENSG00000064726	0	379	84.697	321	58	1	3
ENSG00000064726	ENSG00000133243	0	379	84.697	321	58	3	1
ENSG00000134072	ENSG00000183049	0	323	82.353	266	57	2	3
ENSG00000183049	ENSG00000134072	0	309	84.79	262	47	3	2
ENSG00000136231	ENSG00000159217	0	188	80.319	151	37	1	2
ENSG00000159217	ENSG00000136231	0	163	82.209	134	29	2	1
ENSG00000121454	ENSG00000107187	1.23e-138	127	80.315	102	25	2	3
ENSG00000107187	ENSG00000121454	9.39e-141	126	80.952	102	24	3	2
ENSG00000139648	ENSG00000186049	0	365	89.315	326	39	2	3
ENSG00000186049	ENSG00000139648	0	365	89.315	326	39	3	2
ENSG00000005339	ENSG00000100393	0	471	90.446	426	45	1	2
ENSG00000100393	ENSG00000005339	0	490	88.163	432	58	2	1
ENSG00000083750	ENSG00000155876	0	273	97.802	267	6	3	2
ENSG00000155876	ENSG00000083750	0	273	97.802	267	6	2	3
ENSG00000047457	ENSG00000163755	0	411	100	411	0	2	-1
ENSG00000163755	ENSG00000047457	0	411	100	411	0	-1	2
ENSG00000128881	ENSG00000146216	0	314	81.529	256	58	2	3
ENSG00000146216	ENSG00000128881	0	317	81.073	257	60	3	2
ENSG00000136240	ENSG00000105438	1.05e-123	213	83.568	178	35	3	1
ENSG00000105438	ENSG00000136240	1.53e-108	184	84.239	155	29	1	3
ENSG00000126934	ENSG00000169032	0	228	92.544	211	17	3	1
ENSG00000169032	ENSG00000126934	0	225	92.444	208	17	1	3
ENSG00000137273	ENSG00000103241	4.21e-66	113	96.46	109	4	1	2
ENSG00000103241	ENSG00000137273	1.65e-68	127	90.551	115	12	2	1
ENSG00000138083	ENSG00000184302	2.24e-131	210	86.667	182	28	1	2
ENSG00000184302	ENSG00000138083	1.39e-127	209	86.603	181	28	2	1
ENSG00000136379	ENSG00000129968	2.42e-152	240	82.917	199	41	2	3
ENSG00000129968	ENSG00000136379	1.27e-140	249	80.723	201	48	3	2
ENSG00000134853	ENSG00000113721	0	152	81.579	124	28	2	3
ENSG00000113721	ENSG00000134853	0	154	80.519	124	30	3	2
ENSG00000243709	ENSG00000143768	0	399	94.486	377	22	3	2
ENSG00000143768	ENSG00000243709	0	335	95.821	321	14	2	3
ENSG00000144119	ENSG00000165985	1.2e-92	132	88.636	117	15	3	2
ENSG00000165985	ENSG00000144119	1.58e-86	132	88.636	117	15	2	3
ENSG00000103740	ENSG00000166411	0	870	100	870	0	-1	1
ENSG00000166411	ENSG00000103740	0	869	100	869	0	1	-1
ENSG00000133026	ENSG00000133392	0	981	81.957	804	177	2	3
ENSG00000133392	ENSG00000133026	0	896	82.478	739	157	3	2
ENSG00000135100	ENSG00000157895	0	474	100	474	0	3	-1
ENSG00000157895	ENSG00000135100	0	477	100	477	0	-1	3
ENSG00000141965	ENSG00000145780	0	115	83.478	96	19	1	2
ENSG00000145780	ENSG00000141965	0	115	83.478	96	19	2	1
ENSG00000139266	ENSG00000144583	9.52e-99	159	90.566	144	15	3	1
ENSG00000144583	ENSG00000139266	2.45e-122	185	86.486	160	25	1	3
ENSG00000136842	ENSG00000136925	0	555	100	555	0	-1	3
ENSG00000136925	ENSG00000136842	0	555	100	555	0	3	-1
ENSG00000135945	ENSG00000158417	3.6e-180	284	100	284	0	3	-1
ENSG00000135945	ENSG00000158417	3.55e-180	284	100	284	0	1	-1
ENSG00000158417	ENSG00000135945	4.4e-180	284	100	284	0	-1	3
ENSG00000158417	ENSG00000135945	4.4e-180	284	100	284	0	-1	1
ENSG00000081019	ENSG00000187257	0	363	82.369	299	64	2	1
ENSG00000187257	ENSG00000081019	0	363	82.369	299	64	1	2
ENSG00000126814	ENSG00000198830	1.41e-156	183	85.246	156	27	2	1
ENSG00000198830	ENSG00000126814	0	177	85.876	152	25	2	1
ENSG00000116254	ENSG00000111642	0	349	86.533	302	47	2	3
ENSG00000111642	ENSG00000116254	0	529	88.658	469	60	3	2
ENSG00000181381	ENSG00000137628	0	150	80.667	121	29	3	2
ENSG00000137628	ENSG00000181381	0	150	80.667	121	29	2	3
ENSG00000084731	ENSG00000101350	0	115	82.609	95	20	2	3
ENSG00000101350	ENSG00000084731	0	114	83.333	95	19	3	2
ENSG00000135018	ENSG00000188021	0	163	90.184	147	16	1	2
ENSG00000188021	ENSG00000135018	0	153	90.85	139	14	2	1
ENSG00000113712	ENSG00000180138	0	335	81.194	272	63	3	2
ENSG00000180138	ENSG00000113712	0	334	81.138	271	63	2	3
ENSG00000141429	ENSG00000144278	0	505	85.941	434	71	2	1
ENSG00000144278	ENSG00000141429	0	505	85.941	434	71	1	2
ENSG00000138685	ENSG00000170917	5.26e-138	196	98.98	194	2	2	-2
ENSG00000170917	ENSG00000138685	8.38e-139	196	98.98	194	2	-2	2
ENSG00000170917	ENSG00000138685	6.74e-139	196	98.98	194	2	-2	2
ENSG00000136682	ENSG00000172785	0	597	98.66	589	8	-1	-2
ENSG00000172785	ENSG00000136682	0	597	98.66	589	8	-2	-1
ENSG00000141232	ENSG00000183864	1.74e-82	121	80.165	97	24	1	3
ENSG00000183864	ENSG00000141232	1.45e-68	121	80.165	97	24	3	1
ENSG00000137801	ENSG00000186340	0	261	83.142	217	44	1	2
ENSG00000186340	ENSG00000137801	0	259	83.012	215	44	2	1
ENSG00000139112	ENSG00000170296	1.39e-68	116	87.069	101	15	2	3
ENSG00000170296	ENSG00000139112	1e-66	116	87.069	101	15	3	2
ENSG00000143933	ENSG00000160014	4.47e-98	153	99.346	152	1	3	2
ENSG00000160014	ENSG00000143933	8.6e-98	153	99.346	152	1	2	3
ENSG00000100764	ENSG00000119720	0	567	99.471	564	3	3	-3
ENSG00000119720	ENSG00000100764	0	567	99.471	564	3	-3	3
ENSG00000109158	ENSG00000145863	0	334	83.533	279	55	3	2
ENSG00000145863	ENSG00000109158	0	334	83.533	279	55	2	3
ENSG00000105464	ENSG00000161509	0	418	83.493	349	69	2	1
ENSG00000161509	ENSG00000105464	0	418	83.493	349	69	1	2
ENSG00000136698	ENSG00000152093	0	250	99.6	249	1	3	1
ENSG00000152093	ENSG00000136698	0	250	99.6	249	1	1	3
ENSG00000116489	ENSG00000198898	1.19e-164	288	86.806	250	38	1	2
ENSG00000198898	ENSG00000116489	2.09e-164	288	86.806	250	38	2	1
ENSG00000165055	ENSG00000087995	0	458	95.633	438	20	1	3
ENSG00000087995	ENSG00000165055	0	452	96.239	435	17	3	1
ENSG00000112246	ENSG00000159263	0	359	86.072	309	50	3	2
ENSG00000112246	ENSG00000159263	0	359	86.072	309	50	1	2
ENSG00000159263	ENSG00000112246	0	359	86.072	309	50	2	3
ENSG00000159263	ENSG00000112246	0	359	86.072	309	50	2	1
ENSG00000102753	ENSG00000186432	0	523	85.851	449	74	2	1
ENSG00000186432	ENSG00000102753	0	523	85.851	449	74	1	2
ENSG00000139946	ENSG00000197329	0	411	81.752	336	75	2	3
ENSG00000197329	ENSG00000139946	0	411	81.752	336	75	3	2
ENSG00000221866	ENSG00000076356	0	726	81.818	594	132	2	3
ENSG00000221866	ENSG00000076356	0	726	81.818	594	132	1	3
ENSG00000076356	ENSG00000221866	0	634	84.227	534	100	3	2
ENSG00000076356	ENSG00000221866	0	634	84.227	534	100	3	1
ENSG00000008226	ENSG00000060971	1.28e-87	143	97.902	140	3	-1	1
ENSG00000008226	ENSG00000060971	1.28e-87	143	97.902	140	3	-1	2
ENSG00000060971	ENSG00000008226	3.34e-88	143	97.902	140	3	1	-1
ENSG00000060971	ENSG00000008226	2.85e-88	143	97.902	140	3	2	-1
ENSG00000146707	ENSG00000188372	2.13e-126	111	98.198	109	2	-1	-3
ENSG00000188372	ENSG00000146707	2.12e-126	111	98.198	109	2	-3	-1
ENSG00000163286	ENSG00000163283	0	488	97.746	477	11	2	3
ENSG00000163283	ENSG00000163286	0	493	97.566	481	12	3	2
ENSG00000181826	ENSG00000154274	2.82e-82	142	99.296	141	1	1	-2
ENSG00000154274	ENSG00000181826	4.31e-82	142	99.296	141	1	-2	1
ENSG00000154274	ENSG00000181826	4.3e-82	142	99.296	141	1	-2	1
ENSG00000164933	ENSG00000164934	2.34e-49	108	99.074	107	1	-2	1
ENSG00000164934	ENSG00000164933	2.13e-49	108	99.074	107	1	1	-2
ENSG00000152977	ENSG00000156925	5.18e-136	186	89.785	167	19	1	2
ENSG00000156925	ENSG00000152977	7.45e-158	185	89.73	166	19	2	1
ENSG00000153779	ENSG00000176679	1.5e-124	197	92.893	183	14	-2	-1
ENSG00000176679	ENSG00000153779	9.45e-127	197	92.893	183	14	-1	-2
ENSG00000173451	ENSG00000133858	0	320	99.688	319	1	2	-2
ENSG00000133858	ENSG00000173451	0	320	99.688	319	1	-2	2
ENSG00000181541	ENSG00000180660	0	386	92.746	358	28	2	1
ENSG00000180660	ENSG00000181541	0	374	94.118	352	22	1	2
ENSG00000181789	ENSG00000158623	0	596	83.725	499	97	3	2
ENSG00000158623	ENSG00000181789	0	585	83.761	490	95	2	3
ENSG00000148377	ENSG00000107937	0	311	100	311	0	-2	3
ENSG00000107937	ENSG00000148377	0	311	100	311	0	3	-2
ENSG00000075886	ENSG00000152086	0	330	97.576	322	8	-3	-2
ENSG00000152086	ENSG00000075886	0	288	96.181	277	11	-2	-3
ENSG00000177971	ENSG00000173548	1.11e-155	128	100	128	0	-1	1
ENSG00000173548	ENSG00000177971	4.63e-155	128	100	128	0	1	-1
ENSG00000167191	ENSG00000174628	0	592	100	592	0	3	-2
ENSG00000174628	ENSG00000167191	0	592	100	592	0	-2	3
ENSG00000005022	ENSG00000151729	1.67e-176	299	88.963	266	33	3	1
ENSG00000151729	ENSG00000005022	6.34e-176	299	88.963	266	33	1	3
ENSG00000167553	ENSG00000167552	0	463	88.553	410	53	-3	-2
ENSG00000167552	ENSG00000167553	0	454	89.427	406	48	-2	-3
ENSG00000272617	ENSG00000258429	2.75e-126	189	98.413	186	3	1	3
ENSG00000258429	ENSG00000272617	6.82e-127	189	98.413	186	3	3	1
ENSG00000172345	ENSG00000172349	0	1381	100	1381	0	2	-2
ENSG00000172349	ENSG00000172345	0	1381	100	1381	0	-2	2
ENSG00000155428	ENSG00000178809	0	389	99.743	388	1	3	2
ENSG00000178809	ENSG00000155428	0	345	99.42	343	2	-2	-3
ENSG00000166800	ENSG00000171989	0	332	82.229	273	59	3	2
ENSG00000171989	ENSG00000166800	0	341	82.698	282	59	2	3
ENSG00000104043	ENSG00000143515	0	189	81.481	154	35	2	1
ENSG00000143515	ENSG00000104043	0	110	88.182	97	13	1	2
ENSG00000198077	ENSG00000255974	0	490	94.082	461	29	3	1
ENSG00000255974	ENSG00000198077	0	535	91.402	489	46	1	3
ENSG00000164900	ENSG00000168505	2.45e-69	108	87.037	94	14	1	3
ENSG00000168505	ENSG00000164900	1.17e-69	100	90	90	10	3	1
ENSG00000152270	ENSG00000172572	0	100	84	84	16	3	2
ENSG00000172572	ENSG00000152270	0	128	82.031	105	23	2	3
ENSG00000177879	ENSG00000157823	9.06e-109	192	84.375	162	30	3	1
ENSG00000157823	ENSG00000177879	3.28e-108	192	84.375	162	30	1	3
ENSG00000146083	ENSG00000137075	4.86e-147	118	84.746	100	18	1	3
ENSG00000137075	ENSG00000146083	2.01e-136	118	84.746	100	18	3	1
ENSG00000167977	ENSG00000180901	3.13e-106	162	83.951	136	26	3	1
ENSG00000180901	ENSG00000167977	6.85e-96	162	83.951	136	26	1	3
ENSG00000146049	ENSG00000146038	6.53e-124	199	99.497	198	1	-3	2
ENSG00000146038	ENSG00000146049	2.41e-123	199	99.497	198	1	2	-3
ENSG00000181693	ENSG00000181767	0	345	85.797	296	49	2	3
ENSG00000181767	ENSG00000181693	0	351	85.755	301	50	2	3
ENSG00000166794	ENSG00000157734	5.17e-92	111	100	111	0	-3	3
ENSG00000157734	ENSG00000166794	9.44e-94	111	100	111	0	3	-3
ENSG00000171103	ENSG00000163806	2.43e-96	133	99.248	132	1	2	-1
ENSG00000163806	ENSG00000171103	4.26e-99	132	100	132	0	1	-2
ENSG00000163806	ENSG00000171103	4.16e-99	132	100	132	0	1	-2
ENSG00000165516	ENSG00000165525	0	550	99.818	549	1	2	-3
ENSG00000165525	ENSG00000165516	0	550	99.818	549	1	-3	2
ENSG00000256713	ENSG00000229183	0	506	99.407	503	3	-1	-2
ENSG00000229183	ENSG00000256713	0	506	99.407	503	3	-2	-1
ENSG00000172058	ENSG00000205572	5.94e-136	211	100	211	0	-1	-2
ENSG00000205572	ENSG00000172058	4.06e-136	211	100	211	0	-2	-1
ENSG00000169618	ENSG00000169621	0	241	100	241	0	-3	-2
ENSG00000169621	ENSG00000169618	0	241	100	241	0	-2	-3
ENSG00000173020	ENSG00000100077	0	685	84.088	576	109	3	1
ENSG00000100077	ENSG00000173020	0	687	83.988	577	110	1	3
ENSG00000175077	ENSG00000198471	7.41e-100	169	89.349	151	18	-2	-1
ENSG00000198471	ENSG00000175077	2.46e-96	127	92.126	117	10	-1	-2
ENSG00000244414	ENSG00000080910	0	172	98.256	169	3	-3	-1
ENSG00000080910	ENSG00000244414	0	172	98.256	169	3	-1	-3
ENSG00000172519	ENSG00000186723	0	318	92.767	295	23	-1	-2
ENSG00000186723	ENSG00000172519	0	325	91.077	296	29	-2	-1
ENSG00000175344	ENSG00000166664	0	450	99.778	449	1	1	3
ENSG00000166664	ENSG00000175344	0	463	99.784	462	1	3	1
ENSG00000057149	ENSG00000206073	0	383	91.906	352	31	2	1
ENSG00000206073	ENSG00000057149	0	583	91.767	535	48	1	2
ENSG00000170950	ENSG00000102144	0	405	87.16	353	52	1	3
ENSG00000102144	ENSG00000170950	0	421	87.173	367	54	3	1
ENSG00000092871	ENSG00000005156	0	867	100	867	0	-2	1
ENSG00000092871	ENSG00000005156	0	867	100	867	0	1	-2
ENSG00000005156	ENSG00000092871	0	867	100	867	0	1	-2
ENSG00000005156	ENSG00000092871	0	867	100	867	0	-2	1
ENSG00000166363	ENSG00000170790	0	342	92.105	315	27	-2	-3
ENSG00000170790	ENSG00000166363	0	338	92.012	311	27	-3	-2
ENSG00000187048	ENSG00000162365	0	479	95.407	457	22	3	2
ENSG00000162365	ENSG00000187048	0	528	94.886	501	27	2	3
ENSG00000153922	ENSG00000173575	0	499	85.972	429	70	2	1
ENSG00000173575	ENSG00000153922	0	531	85.687	455	76	1	2
ENSG00000163464	ENSG00000180871	1.99e-153	292	84.589	247	45	-2	-3
ENSG00000180871	ENSG00000163464	6.51e-146	305	82.623	252	53	-3	-2
ENSG00000106714	ENSG00000154529	0	1216	98.273	1195	21	3	1
ENSG00000154529	ENSG00000106714	0	1216	98.273	1195	21	1	3
ENSG00000168928	ENSG00000168925	5.29e-158	154	96.104	148	6	-1	-3
ENSG00000168925	ENSG00000168928	4.86e-158	154	96.104	148	6	-3	-1
ENSG00000170262	ENSG00000142207	3.86e-139	203	100	203	0	3	-2
ENSG00000170262	ENSG00000142207	8.54e-129	203	100	203	0	-1	2
ENSG00000142207	ENSG00000170262	5.2e-138	203	100	203	0	-2	3
ENSG00000142207	ENSG00000170262	1.15e-127	203	100	203	0	2	-1
ENSG00000166947	ENSG00000166946	0	361	100	361	0	1	-3
ENSG00000166946	ENSG00000166947	0	361	100	361	0	-3	1
ENSG00000151693	ENSG00000119185	0	736	100	736	0	-1	2
ENSG00000119185	ENSG00000151693	0	736	100	736	0	2	-1
ENSG00000146281	ENSG00000166200	7.57e-86	132	82.576	109	23	1	3
ENSG00000166200	ENSG00000146281	1.07e-85	132	82.576	109	23	3	1
ENSG00000164729	ENSG00000177710	0	380	93.684	356	24	-1	-2
ENSG00000177710	ENSG00000164729	0	184	92.935	171	13	-2	-1
ENSG00000168961	ENSG00000171916	0	322	94.72	305	17	2	1
ENSG00000171916	ENSG00000168961	0	322	94.72	305	17	1	2
ENSG00000166503	ENSG00000136404	0	312	99.359	310	2	-2	3
ENSG00000136404	ENSG00000166503	0	312	99.359	310	2	3	-2
ENSG00000163322	ENSG00000163319	0	394	99.746	393	1	2	-2
ENSG00000163319	ENSG00000163322	0	394	99.746	393	1	-2	2
ENSG00000154025	ENSG00000154016	0	494	99.595	492	2	3	-1
ENSG00000154016	ENSG00000154025	0	494	99.595	492	2	-1	3
ENSG00000196778	ENSG00000181963	2.47e-172	324	83.951	272	52	-2	-1
ENSG00000181963	ENSG00000196778	1.17e-170	321	90.654	291	30	1	2
ENSG00000164855	ENSG00000198517	4.09e-178	269	100	269	0	-2	2
ENSG00000164855	ENSG00000198517	9.81e-149	269	100	269	0	2	-1
ENSG00000198517	ENSG00000164855	2.15e-178	269	100	269	0	2	-2
ENSG00000198517	ENSG00000164855	5.16e-149	269	100	269	0	-1	2
ENSG00000123064	ENSG00000186710	2.17e-94	125	100	125	0	-1	3
ENSG00000186710	ENSG00000123064	8.45e-94	130	100	130	0	3	-1
ENSG00000173349	ENSG00000136709	0	692	100	692	0	3	-3
ENSG00000136709	ENSG00000173349	0	692	100	692	0	-3	3
ENSG00000160339	ENSG00000085265	1.03e-162	219	84.018	184	35	2	3
ENSG00000085265	ENSG00000160339	2.43e-169	234	80.769	189	45	3	2
ENSG00000162391	ENSG00000162390	9.79e-180	255	99.608	254	1	-3	1
ENSG00000162390	ENSG00000162391	1.55e-179	255	99.608	254	1	1	-3
ENSG00000165646	ENSG00000165650	0	718	100	718	0	2	-2
ENSG00000165650	ENSG00000165646	0	718	100	718	0	-2	2
ENSG00000149289	ENSG00000102053	0	258	83.333	215	43	1	2
ENSG00000102053	ENSG00000149289	0	258	83.333	215	43	2	1
ENSG00000167721	ENSG00000167720	0	243	99.588	242	1	-2	2
ENSG00000167720	ENSG00000167721	0	243	99.588	242	1	2	-2
ENSG00000166439	ENSG00000166435	0	727	100	727	0	-3	2
ENSG00000166435	ENSG00000166439	0	727	100	727	0	2	-3
ENSG00000167395	ENSG00000151006	1.44e-89	128	100	128	0	1	-1
ENSG00000167395	ENSG00000151006	2.17e-83	128	100	128	0	3	-3
ENSG00000151006	ENSG00000167395	4.21e-90	128	100	128	0	-1	1
ENSG00000151006	ENSG00000167395	6.35e-84	128	100	128	0	-3	3
ENSG00000168569	ENSG00000185475	1.84e-85	145	100	145	0	-1	1
ENSG00000185475	ENSG00000168569	1.41e-85	145	100	145	0	1	-1
ENSG00000111196	ENSG00000162385	1.95e-96	148	98.649	146	2	2	1
ENSG00000162385	ENSG00000111196	4.83e-97	148	98.649	146	2	1	2
ENSG00000157326	ENSG00000187630	0	235	91.064	214	21	3	1
ENSG00000187630	ENSG00000157326	0	235	91.064	214	21	1	3
ENSG00000248871	ENSG00000161955	0	431	98.144	423	8	-1	-2
ENSG00000161955	ENSG00000248871	0	431	98.144	423	8	-2	-1
ENSG00000171446	ENSG00000204897	0	269	91.45	246	23	3	2
ENSG00000204897	ENSG00000171446	0	269	91.45	246	23	2	3
ENSG00000173273	ENSG00000107854	0	615	85.041	523	92	3	2
ENSG00000107854	ENSG00000173273	0	383	86.162	330	53	2	3
ENSG00000167702	ENSG00000160973	2.34e-166	263	100	263	0	1	-2
ENSG00000160973	ENSG00000167702	1.57e-166	263	100	263	0	-2	1
ENSG00000128886	ENSG00000167004	2.38e-124	210	100	210	0	-1	3
ENSG00000167004	ENSG00000128886	3.86e-124	210	100	210	0	3	-1
ENSG00000160683	ENSG00000186174	0	882	100	882	0	3	-1
ENSG00000186174	ENSG00000160683	0	882	100	882	0	-1	3
ENSG00000172939	ENSG00000198648	0	338	83.728	283	55	1	2
ENSG00000198648	ENSG00000172939	0	368	83.424	307	61	2	1
ENSG00000166351	ENSG00000183206	0	536	96.455	517	19	2	1
ENSG00000183206	ENSG00000166351	0	536	96.455	517	19	1	2
ENSG00000157827	ENSG00000161791	0	130	86.154	112	18	2	1
ENSG00000161791	ENSG00000157827	0	391	82.353	322	69	1	2
ENSG00000166377	ENSG00000054793	0	570	82.281	469	101	3	2
ENSG00000054793	ENSG00000166377	0	570	82.281	469	101	2	3
ENSG00000148136	ENSG00000204246	5.88e-176	317	83.912	266	51	1	2
ENSG00000204246	ENSG00000148136	4.33e-166	317	83.912	266	51	2	1
ENSG00000149968	ENSG00000166670	0	217	85.714	186	31	3	2
ENSG00000166670	ENSG00000149968	0	390	80.256	313	77	2	3
ENSG00000171478	ENSG00000171489	5.78e-119	170	100	170	0	1	3
ENSG00000171478	ENSG00000171489	6.26e-112	170	100	170	0	2	1
ENSG00000171489	ENSG00000171478	6.43e-119	170	100	170	0	3	1
ENSG00000171489	ENSG00000171478	6.96e-112	170	100	170	0	1	2
ENSG00000158714	ENSG00000188004	0	327	99.388	325	2	-1	2
ENSG00000188004	ENSG00000158714	0	327	99.388	325	2	2	-1
ENSG00000163888	ENSG00000145194	2.48e-84	124	100	124	0	1	-2
ENSG00000145194	ENSG00000163888	3.42e-84	124	100	124	0	-2	1
ENSG00000151746	ENSG00000185963	0	201	85.572	172	29	2	3
ENSG00000185963	ENSG00000151746	0	185	89.189	165	20	3	2
ENSG00000213512	ENSG00000162654	0	482	82.365	397	85	2	3
ENSG00000162654	ENSG00000213512	0	482	82.365	397	85	3	2
ENSG00000153147	ENSG00000102038	0	750	86.4	648	102	1	2
ENSG00000102038	ENSG00000153147	0	753	86.321	650	103	2	1
ENSG00000178934	ENSG00000205076	1.69e-103	155	100	155	0	2	1
ENSG00000205076	ENSG00000178934	1.58e-103	155	100	155	0	1	2
ENSG00000187527	ENSG00000127249	0	108	80.556	87	21	2	3
ENSG00000127249	ENSG00000187527	0	108	80.556	87	21	3	2
ENSG00000178802	ENSG00000178761	0	744	100	744	0	-2	2
ENSG00000178761	ENSG00000178802	0	744	100	744	0	2	-2
ENSG00000100023	ENSG00000100027	0	569	100	569	0	2	-2
ENSG00000100027	ENSG00000100023	0	569	100	569	0	-2	2
ENSG00000104177	ENSG00000188467	0	222	97.297	216	6	1	-2
ENSG00000188467	ENSG00000104177	0	222	97.297	216	6	-2	1
ENSG00000177182	ENSG00000198363	0	363	100	363	0	3	-1
ENSG00000198363	ENSG00000177182	0	363	100	363	0	-1	3
ENSG00000183281	ENSG00000125551	0	388	99.742	387	1	1	2
ENSG00000125551	ENSG00000183281	0	388	99.742	387	1	2	1
ENSG00000114374	ENSG00000124486	0	473	88.795	420	53	-3	-1
ENSG00000124486	ENSG00000114374	0	332	89.458	297	35	-1	-3
ENSG00000197172	ENSG00000221867	0	466	96.996	452	14	3	2
ENSG00000221867	ENSG00000197172	0	466	96.996	452	14	2	3
ENSG00000127955	ENSG00000065135	0	362	92.541	335	27	2	3
ENSG00000065135	ENSG00000127955	0	319	91.85	293	26	3	2
ENSG00000070808	ENSG00000058404	0	476	85.714	408	68	1	2
ENSG00000058404	ENSG00000070808	0	476	85.714	408	68	2	1
ENSG00000215252	ENSG00000175265	0	258	100	258	0	-1	-3
ENSG00000175265	ENSG00000215252	0	258	100	258	0	-3	-1
ENSG00000197021	ENSG00000197620	0	355	97.183	345	10	-1	-2
ENSG00000197620	ENSG00000197021	0	263	96.578	254	9	-1	-2
ENSG00000196735	ENSG00000237541	0	323	85.449	276	47	-2	-1
ENSG00000237541	ENSG00000196735	0	323	85.449	276	47	-1	-2
ENSG00000132356	ENSG00000162409	0	243	82.716	201	42	3	1
ENSG00000162409	ENSG00000132356	0	243	82.716	201	42	1	3
ENSG00000131584	ENSG00000114331	1.81e-67	122	81.148	99	23	3	1
ENSG00000114331	ENSG00000131584	1.5e-81	122	81.148	99	23	1	3
ENSG00000187082	ENSG00000186579	3.44e-60	100	100	100	0	3	2
ENSG00000187082	ENSG00000186579	6e-51	100	100	100	0	1	3
ENSG00000186579	ENSG00000187082	3.21e-60	100	100	100	0	2	3
ENSG00000186579	ENSG00000187082	5.6e-51	100	100	100	0	3	1
ENSG00000122824	ENSG00000196368	8.89e-136	177	96.045	170	7	-3	-2
ENSG00000122824	ENSG00000196368	3.64e-134	177	96.045	170	7	-3	-2
ENSG00000196368	ENSG00000122824	8.63e-139	180	93.333	168	12	-2	-3
ENSG00000196368	ENSG00000122824	2.41e-126	180	93.333	168	12	-2	-3
ENSG00000186510	ENSG00000184908	0	687	91.266	627	60	2	1
ENSG00000184908	ENSG00000186510	0	687	91.266	627	60	1	2
ENSG00000186599	ENSG00000186562	4.36e-74	110	100	110	0	2	1
ENSG00000186562	ENSG00000186599	4.36e-74	110	100	110	0	1	2
ENSG00000119723	ENSG00000187097	1.22e-153	235	99.574	234	1	2	-2
ENSG00000187097	ENSG00000119723	3.51e-153	235	99.574	234	1	-2	2
ENSG00000187243	ENSG00000154545	0	612	100	612	0	1	2
ENSG00000154545	ENSG00000187243	0	612	100	612	0	2	1
ENSG00000179914	ENSG00000158764	0	283	88.693	251	32	3	2
ENSG00000158764	ENSG00000179914	0	283	88.693	251	32	2	3
ENSG00000240654	ENSG00000205863	0	226	95.133	215	11	2	3
ENSG00000205863	ENSG00000240654	0	403	97.022	391	12	-2	-3
ENSG00000186119	ENSG00000205029	3.26e-148	304	81.25	247	57	3	1
ENSG00000205029	ENSG00000186119	4.44e-160	304	81.25	247	57	1	3
ENSG00000241119	ENSG00000242366	0	778	96.53	751	27	2	1
ENSG00000242366	ENSG00000241119	0	646	98.452	636	10	1	2
ENSG00000196565	ENSG00000213934	1.3e-124	195	97.949	191	4	1	3
ENSG00000213934	ENSG00000196565	3.8e-125	196	97.959	192	4	3	1
ENSG00000185009	ENSG00000035403	0	369	100	369	0	2	-1
ENSG00000035403	ENSG00000185009	0	369	100	369	0	-1	2
ENSG00000116721	ENSG00000204481	0	486	96.091	467	19	-3	-1
ENSG00000204481	ENSG00000116721	0	486	96.091	467	19	-1	-3
ENSG00000177613	ENSG00000101811	0	208	87.5	182	26	1	2
ENSG00000101811	ENSG00000177613	0	216	86.111	186	30	2	1
ENSG00000182255	ENSG00000177272	6.96e-172	133	91.729	122	11	2	3
ENSG00000177272	ENSG00000182255	5.55e-173	147	89.796	132	15	3	2
ENSG00000241484	ENSG00000248405	0	269	100	269	0	1	3
ENSG00000248405	ENSG00000241484	0	269	100	269	0	3	1
ENSG00000183682	ENSG00000116985	0	325	95.692	311	14	-3	-1
ENSG00000116985	ENSG00000183682	0	331	95.77	317	14	-1	-3
ENSG00000176490	ENSG00000165023	2.83e-101	126	86.508	109	17	2	1
ENSG00000165023	ENSG00000176490	4.64e-93	129	84.496	109	20	1	2
ENSG00000187634	ENSG00000188976	4.9e-72	124	100	124	0	2	-1
ENSG00000188976	ENSG00000187634	5.4e-72	124	100	124	0	-1	2
ENSG00000076685	ENSG00000148842	0	528	100	528	0	-1	1
ENSG00000148842	ENSG00000076685	0	528	100	528	0	1	-1
ENSG00000099290	ENSG00000172661	0	958	98.225	941	17	1	3
ENSG00000172661	ENSG00000099290	0	554	98.917	548	6	3	1
ENSG00000159899	ENSG00000169418	0	368	80.435	296	72	1	2
ENSG00000169418	ENSG00000159899	0	368	80.435	296	72	2	1
ENSG00000244734	ENSG00000223609	1.73e-87	161	85.093	137	24	-3	-1
ENSG00000223609	ENSG00000244734	2.29e-87	161	85.093	137	24	-1	-3
ENSG00000124593	ENSG00000278224	0	279	100	279	0	3	1
ENSG00000278224	ENSG00000124593	0	279	100	279	0	1	3
ENSG00000184814	ENSG00000206260	1.5e-121	141	88.652	125	16	-3	-1
ENSG00000206260	ENSG00000184814	2.94e-119	125	88.8	111	14	-1	-3
ENSG00000135702	ENSG00000183196	0	364	86.538	315	49	1	3
ENSG00000183196	ENSG00000135702	0	360	86.944	313	47	3	1
ENSG00000196981	ENSG00000196363	0	301	89.369	269	32	2	1
ENSG00000196363	ENSG00000196981	0	320	87.188	279	41	1	2
ENSG00000175029	ENSG00000019995	0	622	100	622	0	2	-2
ENSG00000175029	ENSG00000019995	0	622	100	622	0	-3	1
ENSG00000175029	ENSG00000019995	0	622	100	622	0	1	-1
ENSG00000019995	ENSG00000175029	0	622	100	622	0	-2	2
ENSG00000019995	ENSG00000175029	0	622	100	622	0	1	-3
ENSG00000019995	ENSG00000175029	0	622	100	622	0	-1	1
ENSG00000117009	ENSG00000054277	0	504	100	504	0	-1	3
ENSG00000054277	ENSG00000117009	0	504	100	504	0	3	-1
ENSG00000196873	ENSG00000147996	0	597	99.33	593	4	-2	-1
ENSG00000147996	ENSG00000196873	0	597	99.33	593	4	-1	-2
ENSG00000198889	ENSG00000198354	0	471	86.837	409	62	1	3
ENSG00000198354	ENSG00000198889	0	437	86.041	376	61	3	1
ENSG00000025039	ENSG00000116954	0	336	87.798	295	41	2	1
ENSG00000116954	ENSG00000025039	0	336	87.798	295	41	1	2
ENSG00000131721	ENSG00000203989	0	401	100	401	0	-2	-3
ENSG00000203989	ENSG00000131721	0	401	100	401	0	-3	-2
ENSG00000172288	ENSG00000172352	0	725	100	725	0	3	2
ENSG00000172352	ENSG00000172288	0	725	100	725	0	2	3
ENSG00000137193	ENSG00000198355	2.69e-134	194	80.928	157	37	2	1
ENSG00000198355	ENSG00000137193	1.1e-129	183	81.967	150	33	1	2
ENSG00000138161	ENSG00000213185	6.6e-74	119	95.798	114	5	2	3
ENSG00000213185	ENSG00000138161	1.45e-74	119	95.798	114	5	3	2
ENSG00000168118	ENSG00000213029	2.39e-145	215	100	215	0	2	3
ENSG00000213029	ENSG00000168118	4.29e-146	215	100	215	0	3	2
ENSG00000124103	ENSG00000213714	2.73e-115	228	90.351	206	22	3	1
ENSG00000213714	ENSG00000124103	1.96e-127	228	90.351	206	22	1	3
ENSG00000203785	ENSG00000241794	1.35e-124	166	90.964	151	15	1	2
ENSG00000241794	ENSG00000203785	1.43e-124	166	90.964	151	15	2	1
ENSG00000156875	ENSG00000148110	0	374	84.225	315	59	2	3
ENSG00000148110	ENSG00000156875	0	374	84.225	315	59	3	2
ENSG00000085998	ENSG00000171357	1.26e-137	199	100	199	0	-2	3
ENSG00000171357	ENSG00000085998	7.68e-138	199	100	199	0	3	-2
ENSG00000125356	ENSG00000125352	1.9e-73	113	100	113	0	1	-2
ENSG00000125352	ENSG00000125356	3.67e-73	113	100	113	0	-2	1
ENSG00000203811	ENSG00000278828	2.31e-86	137	99.27	136	1	1	2
ENSG00000278828	ENSG00000203811	1.67e-86	137	99.27	136	1	2	1
ENSG00000198626	ENSG00000196218	0	129	87.597	113	16	3	1
ENSG00000196218	ENSG00000198626	0	122	87.705	107	15	1	3
ENSG00000143556	ENSG00000184330	8.59e-81	145	88.276	128	17	2	1
ENSG00000184330	ENSG00000143556	8.5e-81	145	88.276	128	17	1	2
ENSG00000068383	ENSG00000148826	3.88e-63	100	100	100	0	1	-1
ENSG00000148826	ENSG00000068383	3.47e-63	100	100	100	0	-1	1
ENSG00000096080	ENSG00000172426	4.84e-152	215	95.349	205	10	1	-2
ENSG00000172426	ENSG00000096080	1.26e-151	215	95.349	205	10	-2	1
ENSG00000172426	ENSG00000096080	1.29e-151	215	95.349	205	10	-2	1
ENSG00000184388	ENSG00000186288	0	269	99.257	267	2	-3	-1
ENSG00000186288	ENSG00000184388	0	269	99.257	267	2	-1	-3
ENSG00000007341	ENSG00000134245	0	668	99.551	665	3	-2	3
ENSG00000134245	ENSG00000007341	0	668	99.551	665	3	3	-2
ENSG00000121481	ENSG00000204227	1.69e-123	151	84.106	127	24	1	2
ENSG00000204227	ENSG00000121481	3.56e-123	151	84.106	127	24	2	1
ENSG00000167136	ENSG00000198917	1.98e-95	122	96.721	118	4	-3	2
ENSG00000198917	ENSG00000167136	3.44e-92	122	96.721	118	4	2	-3
ENSG00000130827	ENSG00000114554	0	623	83.949	523	100	2	1
ENSG00000114554	ENSG00000130827	0	635	82.677	525	110	1	2
ENSG00000174876	ENSG00000187733	0	538	100	538	0	-3	-1
ENSG00000187733	ENSG00000174876	0	537	100	537	0	-1	-3
ENSG00000196475	ENSG00000198814	0	556	88.309	491	65	1	3
ENSG00000198814	ENSG00000196475	0	457	85.339	390	67	-1	-3
ENSG00000143184	ENSG00000143185	5.96e-119	188	95.745	180	8	-3	-2
ENSG00000143185	ENSG00000143184	2.08e-119	188	95.745	180	8	-2	-3
ENSG00000142615	ENSG00000215704	1.05e-164	258	90.31	233	25	-2	-3
ENSG00000215704	ENSG00000142615	1.22e-174	300	88.667	266	34	-3	-2
ENSG00000196126	ENSG00000198502	0	332	87.952	292	40	-2	-1
ENSG00000198502	ENSG00000196126	0	332	87.952	292	40	-1	-2
ENSG00000214827	ENSG00000182712	5.09e-90	152	99.342	151	1	-1	-3
ENSG00000182712	ENSG00000214827	2.31e-90	152	99.342	151	1	-3	-1
ENSG00000203923	ENSG00000204363	0	206	89.806	185	21	3	2
ENSG00000204363	ENSG00000203923	0	206	89.806	185	21	2	3
ENSG00000122136	ENSG00000171102	1.79e-142	229	94.323	216	13	-3	-2
ENSG00000171102	ENSG00000122136	1.8e-142	229	94.323	216	13	-2	-3
ENSG00000102359	ENSG00000102362	0	432	100	432	0	3	-1
ENSG00000102359	ENSG00000102362	0	432	100	432	0	1	-2
ENSG00000102362	ENSG00000102359	0	432	100	432	0	1	-3
ENSG00000102362	ENSG00000102359	0	432	100	432	0	-1	3
ENSG00000102362	ENSG00000102359	0	432	100	432	0	-2	1
ENSG00000213648	ENSG00000261052	0	426	99.531	424	2	-1	-2
ENSG00000261052	ENSG00000213648	0	426	99.531	424	2	-2	-1
ENSG00000204147	ENSG00000188611	0	741	98.516	730	11	-2	-3
ENSG00000188611	ENSG00000204147	0	741	98.516	730	11	-3	-2
ENSG00000205497	ENSG00000205496	0	314	96.815	304	10	3	1
ENSG00000205496	ENSG00000205497	0	314	96.815	304	10	1	3
ENSG00000172062	ENSG00000205571	0	192	100	192	0	1	3
ENSG00000205571	ENSG00000172062	0	192	100	192	0	3	1
ENSG00000204388	ENSG00000204389	0	616	100	616	0	1	3
ENSG00000204389	ENSG00000204388	0	616	100	616	0	3	1
ENSG00000205476	ENSG00000090061	0	447	100	447	0	-3	2
ENSG00000090061	ENSG00000205476	0	447	100	447	0	2	-3
ENSG00000241978	ENSG00000157654	0	907	100	907	0	1	3
ENSG00000157654	ENSG00000241978	0	907	100	907	0	3	1
ENSG00000212722	ENSG00000212721	2.61e-130	132	84.848	112	20	-2	-1
ENSG00000212721	ENSG00000212722	2.23e-121	132	84.848	112	20	-1	-2
ENSG00000184659	ENSG00000204779	0	407	99.017	403	4	1	2
ENSG00000204779	ENSG00000184659	0	407	99.017	403	4	2	1
